"Código Establecimiento","Nombre Establecimiento","ID Comuna","Nombre Comuna","Femenino","Masculino","Total Estudiantes"
"5","JOVINA NARANJO FERNANDEZ","15101","ARICA","10","19","29"
"8","COLEGIO INTEGRADO EDUARDO FREI MONTALVA","15101","ARICA","13","11","24"
"9","ESCUELA REPUBLICA DE ISRAEL","15101","ARICA","72","78","150"
"10","ESCUELA REPUBLICA DE FRANCIA","15101","ARICA","16","0","16"
"11","ESC. GRAL. PEDRO LAGOS MARCHANT","15101","ARICA","21","17","38"
"12","ESCUELA GRAL JOSE MIGUEL CARRERA","15101","ARICA","20","11","31"
"13","ESCUELA MANUEL RODRIGUEZ ERDOYZA","15101","ARICA","8","17","25"
"14","ESCUELA ROMULO J. PENA MATURANA","15101","ARICA","8","17","25"
"15","LICEO ARTISTICO DR. JUAN NOE CREVANI","15101","ARICA","19","18","37"
"16","ESCUELA REGIMIENTO RANCAGUA","15101","ARICA","9","14","23"
"17","ESCUELA SUBTTE. LUIS CRUZ MARTINEZ","15101","ARICA","16","14","30"
"18","ESC. COMTE. JUAN JOSE SAN MARTIN","15101","ARICA","17","22","39"
"19","ESC. HUMBERTO VALENZUELA GARCIA","15101","ARICA","24","15","39"
"20","ESCUELA TUCAPEL","15101","ARICA","14","29","43"
"22","ESCUELA GABRIELA MISTRAL","15101","ARICA","39","48","87"
"25","COLEGIO CENTENARIO DE ARICA","15101","ARICA","22","23","45"
"26","ESCUELA REPUBLICA DE ARGENTINA","15101","ARICA","7","10","17"
"27","ESCUELA ESMERALDA","15101","ARICA","11","18","29"
"28","ESCUELA RICARDO SILVA ARRIAGADA","15101","ARICA","35","30","65"
"29","ESCUELA AMERICA","15101","ARICA","23","27","50"
"31","ESCUELA DARIO SALAS DIAZ","15101","ARICA","20","21","41"
"32","LICEO AGRICOLA JOSE ABELARDO NUNEZ M.","15101","ARICA","22","25","47"
"33","ESCUELA CARLOS CONDELL DE LA HAZA","15101","ARICA","10","10","20"
"36","ESCUELA IGNACIO CARRERA PINTO","15101","ARICA","16","19","35"
"38","ESCUELA ESPAÑA","15101","ARICA","20","20","40"
"72","LICEO  VALLE DE CODPA","15102","CAMARONES","1","4","5"
"78","LICEO GRANADEROS","15201","PUTRE","9","15","24"
"79","ESCUELA EL MARQUEZ","15201","PUTRE","0","4","4"
"90","ESCUELA INTERNADO VISVIRI","15202","GENERAL LAGOS","4","4","8"
"103","ESC.EDUC.GRAL.BAS.Y DES.ART.VIOLETA PARRA","1101","IQUIQUE","30","24","54"
"106","INSTITUTO DEL MAR ALMIRANTE CARLOS CONDEL","1101","IQUIQUE","9","9","18"
"110","LICEO BICENTENARIO DOMINGO SANTA MARIA DE IQQ.","1101","IQUIQUE","33","36","69"
"111","ESCUELA GABRIELA MISTRAL","1101","IQUIQUE","14","23","37"
"112","ESCUELA EDUARDO LLANOS","1101","IQUIQUE","42","30","72"
"113","ESCUELA ALMIRANTE PATRICIO LYNCH","1101","IQUIQUE","41","56","97"
"114","ESCUELA PLACIDO VILLARROEL","1101","IQUIQUE","31","39","70"
"116","COLEGIO REPUBLICA DE CROACIA","1101","IQUIQUE","28","35","63"
"117","ESCUELA PAULA JARAQUEMADA ALQUIZAR","1101","IQUIQUE","16","20","36"
"119","ESCUELA CENTENARIO","1101","IQUIQUE","13","17","30"
"122","ESCUELA THILDA PORTILLO OLIVARES","1101","IQUIQUE","22","14","36"
"123","COLEGIO ESPANA","1101","IQUIQUE","17","33","50"
"125","ESCUELA PROFESOR MANUEL CASTRO RAMOS","1101","IQUIQUE","49","52","101"
"126","COLEGIO REPUBLICA DE ITALIA","1101","IQUIQUE","26","29","55"
"156","ESCUELA PISAGUA","1404","HUARA","4","1","5"
"160","ESCUELA PACHICA","1404","HUARA","1","3","4"
"161","LICEO DE HUARA","1404","HUARA","16","15","31"
"167","ESCUELA CAMINA","1402","CAMIÑA","5","8","13"
"178","LICEO TECNICO PROFESIONAL COLCHANE","1403","COLCHANE","9","7","16"
"187","ESCUELA VERTIENTE DEL SABER","1405","PICA","7","14","21"
"188","ESC. MATILLA DE NUEVA EXTREMADURA","1405","PICA","9","6","15"
"192","ESCUELA BASICA MAMINA","1401","POZO ALMONTE","4","1","5"
"193","ESCUELA BASICA POZO ALMONTE","1401","POZO ALMONTE","31","24","55"
"195","ESCUELA BASICA LA TIRANA","1401","POZO ALMONTE","10","13","23"
"196","ESCUELA BASICA HUATACONDO","1401","POZO ALMONTE","4","0","4"
"198","ESCUELA BASICA LA HUAYCA","1401","POZO ALMONTE","5","6","11"
"199","LICEO DOMINGO LATRILLE LASTAUNOU","2301","TOCOPILLA","1","2","3"
"201","ESCUELA CARLOS CONDELL DE LA HAZA","2301","TOCOPILLA","22","25","47"
"203","ESCUELA PABLO NERUDA","2301","TOCOPILLA","30","30","60"
"204","ESCUELA L.GRAL.BERNARDO O´HIGGINS R.","2301","TOCOPILLA","23","20","43"
"205","ESCUELA ARTURO PRAT CHACON","2301","TOCOPILLA","22","16","38"
"206","ESCUELA ESTADOS UNIDOS DE NORTEAMERICA","2301","TOCOPILLA","12","20","32"
"210","ESCUELA ARTURO PEREZ CANTO","2302","MARIA ELENA","41","49","90"
"222","CENTRO EDUC.INTEGRAL DE ADULTOS C.E.I.A","2201","CALAMA","8","6","14"
"223","ESCUELA CLAUDIO ARRAU","2201","CALAMA","37","41","78"
"224","ESCUELA GRECIA","2201","CALAMA","55","52","107"
"225","ESCUELA REPUBLICA DE BOLIVIA","2201","CALAMA","33","53","86"
"226","ESCUELA BASICA EMILIO SOTOMAYOR","2201","CALAMA","65","62","127"
"227","ESCUELA BASICA PRESIDENTE BALMACEDA","2201","CALAMA","66","90","156"
"228","ESCUELA BASICA VADO DE TOPATER","2201","CALAMA","36","36","72"
"229","ESCUELA REPUBLICA DE CHILE","2201","CALAMA","27","45","72"
"230","ESCUELA BASICA ANDRES BELLO","2201","CALAMA","34","29","63"
"231","ESCUELA BASICA JOHN FITZGERALD KENNEDY","2201","CALAMA","31","30","61"
"232","ESCUELA BASICA PEDRO VERGARA KELLER","2201","CALAMA","25","41","66"
"239","ESCUELA BASICA 21 DE MAYO","2201","CALAMA","31","37","68"
"240","ESCUELA BASICA REPUBLICA DE FRANCIA","2201","CALAMA","38","41","79"
"246","ESCUELA BASICA SENORA DE LA CANDELARIA","2201","CALAMA","0","1","1"
"252","ESCUELA BASICA SAN FRANCISCO","2201","CALAMA","6","5","11"
"268","ESC. BASICA RURAL SAN ANTONIO DE PADUA","2202","OLLAGÜE","1","0","1"
"270","COMPLEJO EDUCACIONAL TOCONAO","2203","SAN PEDRO DE ATACAMA","10","14","24"
"274","ESCUELA BASICA SAN ROQUE","2203","SAN PEDRO DE ATACAMA","2","2","4"
"280","LICEO COMERCIAL JERARDO MUNOZ CAMPO","2101","ANTOFAGASTA","13","15","28"
"284","LICEO DE HOMBRES DE ANTOFAGASTA MARIO BAHAMONDE SILVA","2101","ANTOFAGASTA","27","35","62"
"285","LICEO MARTA NAREA DIAZ","2101","ANTOFAGASTA","26","20","46"
"287","LICEO DOMINGO HERRERA RIVERA","2101","ANTOFAGASTA","25","9","34"
"288","ESCUELA JAPON","2101","ANTOFAGASTA","60","47","107"
"289","ESCUELA ESPANA","2101","ANTOFAGASTA","27","47","74"
"291","ESCUELA PADRE GUSTAVO LE PAIGE WALQUE","2101","ANTOFAGASTA","69","74","143"
"292","ESCUELA REPUBLICA DE ITALIA","2101","ANTOFAGASTA","37","29","66"
"293","ESCUELA JOSE PAPIC RADNIC","2101","ANTOFAGASTA","72","69","141"
"294","ESCUELA PROFESORA LJUBICA DOMIC WUTH","2101","ANTOFAGASTA","48","47","95"
"296","ESCUELA REPUBLICA DE LOS ESTADOS UNIDOS","2101","ANTOFAGASTA","32","36","68"
"297","ESCUELA ALCALDE MAXIMILIANO POBLETE","2101","ANTOFAGASTA","16","38","54"
"298","ESCUELA DARIO SALAS DIAZ","2101","ANTOFAGASTA","21","27","48"
"301","ESCUELA ROMULO J. PENA MATURANA","2101","ANTOFAGASTA","19","25","44"
"302","ESCUELA JUAN LOPEZ","2101","ANTOFAGASTA","16","14","30"
"303","ESCUELA REPUBLICA ARGENTINA","2101","ANTOFAGASTA","16","22","38"
"304","LICEO ANDRES SABELLA","2101","ANTOFAGASTA","68","66","134"
"305","ESCUELA GONZALEZ ECHEGOYEN","2101","ANTOFAGASTA","56","46","102"
"306","ESCUELA HUANCHACA","2101","ANTOFAGASTA","19","23","42"
"310","ESCUELA CLAUDIO MATTE PEREZ","2101","ANTOFAGASTA","25","22","47"
"312","ESCUELA ECUADOR","2101","ANTOFAGASTA","38","32","70"
"313","ESCUELA ARTURO PRAT","2101","ANTOFAGASTA","59","57","116"
"315","ESCUELA HEROES DE LA CONCEPCION","2101","ANTOFAGASTA","17","17","34"
"317","ESCUELA LAS ROCAS","2101","ANTOFAGASTA","50","54","104"
"318","ESCUELA EDDA CUNEO DONNAGIO","2101","ANTOFAGASTA","10","14","24"
"319","ESCUELA LA BANDERA","2101","ANTOFAGASTA","38","37","75"
"320","ESCUELA ARMANDO CARRERA GONZALEZ","2101","ANTOFAGASTA","30","29","59"
"322","ESCUELA GENERAL MANUEL BAQUEDANO","2101","ANTOFAGASTA","21","23","44"
"324","ESCUELA FUNDACION MINERA ESCONDIDA","2101","ANTOFAGASTA","15","22","37"
"326","ESCUELA SANTIAGO AMENGUAL B.","2101","ANTOFAGASTA","10","18","28"
"329","INSTITUTO CIENTÍFICO EDUCACIONAL JOSÉ MAZA SANCHO","2101","ANTOFAGASTA","17","18","35"
"332","ESCUELA GABRIELA MISTRAL","2101","ANTOFAGASTA","17","10","27"
"367","COMPLEJO EDUCATIVO JUAN JOSE LATORRE BENAVENT","2102","MEJILLONES","23","19","42"
"368","ESCUELA BASICA JULIA HERRERA VARAS","2102","MEJILLONES","37","27","64"
"370","ESCUELA ESTACION BAQUEDANO","2103","SIERRA GORDA","4","7","11"
"371","ESCUELA CARACOLES","2103","SIERRA GORDA","3","3","6"
"372","LICEO POLITECNICO JOSE MIGUEL QUIROZ","2104","TALTAL","30","48","78"
"373","LICEO JUAN CORTES-MONROY CORTES","2104","TALTAL","47","45","92"
"380","ESCUELA BASICA DIEGO PORTALES PALAZUELOS","3201","CHAÑARAL","8","22","30"
"381","ESCUELA BASICA PEDRO LUJAN","3201","CHAÑARAL","4","8","12"
"382","ESCUELA BASICA GASPAR CABRALES","3201","CHAÑARAL","16","12","28"
"386","ESCUELA ALIRO LAMAS CASTILLO","3202","DIEGO DE ALMAGRO","44","42","86"
"387","ESC. BASICA EMPERATRIZ SEPULVEDA LANDEROS","3202","DIEGO DE ALMAGRO","0","1","1"
"400","LICEO MERCEDES FRITIS MACKENNEY","3101","COPIAPO","75","63","138"
"401","ESCUELA BERNARDO O HIGGINS","3101","COPIAPO","40","48","88"
"403","ESCUELA LAURA ROBLES SILVA","3101","COPIAPO","20","35","55"
"405","ESCUELA LOS ESTANDARTES","3101","COPIAPO","19","23","42"
"406","ESCUELA VICENTE SEPULVEDA ROJO","3101","COPIAPO","28","25","53"
"407","ESCUELA JESUS FERNANDEZ HIDALGO","3101","COPIAPO","14","25","39"
"408","ESCUELA PEDRO LEON GALLO","3101","COPIAPO","42","50","92"
"410","ESCUELA JOSE MANSO DE VELASCO","3101","COPIAPO","27","32","59"
"411","ESCUELA LAS CANTERAS","3101","COPIAPO","20","31","51"
"413","ESCUELA LAS BRISAS","3101","COPIAPO","3","13","16"
"415","LICEO DE MUSICA","3101","COPIAPO","56","33","89"
"416","ESCUELA ABRAHAM SEPULVEDA PIZARRO","3101","COPIAPO","24","33","57"
"417","COLEGIO BUEN PASTOR","3101","COPIAPO","22","36","58"
"418","ESCUELA ISABEL PENA MORALES","3101","COPIAPO","39","40","79"
"419","ESCUELA HERNAN MARQUEZ HUERTA","3101","COPIAPO","49","44","93"
"420","ESCUELA FUNDICION PAIPOTE","3101","COPIAPO","19","18","37"
"421","ESCUELA BRUNO ZAVALA FREDES","3101","COPIAPO","36","52","88"
"423","ESCUELA SAN PEDRO","3101","COPIAPO","9","8","17"
"427","ESCUELA LUIS CRUZ MARTINEZ","3101","COPIAPO","9","26","35"
"441","ESCUELA DE CONCENTRACION","3103","TIERRA AMARILLA","11","9","20"
"442","ESCUELA VICTOR MANUEL SANCHEZ CABANAS","3103","TIERRA AMARILLA","18","18","36"
"444","ESCUELA LUIS URIBE ORREGO","3103","TIERRA AMARILLA","11","18","29"
"450","ESCUELA HERMANOS CARRERA","3301","VALLENAR","8","13","21"
"452","ESCUELA GABRIELA MISTRAL","3301","VALLENAR","16","16","32"
"453","ESCUELA IGNACIO CARRERA PINTO","3301","VALLENAR","43","32","75"
"454","ESCUELA GREGORIO CASTILLO MARÍN","3301","VALLENAR","40","41","81"
"455","ESCUELA REPUBLICA DE LOS E.E.U.U.","3301","VALLENAR","7","18","25"
"458","ESCUELA ARTURO PEREZ CANTO","3301","VALLENAR","10","17","27"
"459","ESCUELA BASICA ESPANA","3301","VALLENAR","25","40","65"
"461","ESCUELA LUIS CRUZ MARTINEZ","3301","VALLENAR","9","13","22"
"462","ESCUELA JOSE CAROCA LAFLOR","3301","VALLENAR","12","13","25"
"463","ESCUELA BASICA ROBERTO CUADRA ALQUINTA","3301","VALLENAR","12","2","14"
"464","ESCUELA BASICA GUALBERTO KONG FERNANDEZ","3301","VALLENAR","33","38","71"
"469","ESCUELA BASICA JUSTINO LEIVA AMOR","3301","VALLENAR","2","4","6"
"481","ESCUELA BASICA ALEJANDRO NOEMI HUERTA","3303","FREIRINA","16","13","29"
"487","ESCUELA BASICA JOSE MIGUEL CARRERA","3304","HUASCO","13","13","26"
"489","ESCUELA EL OLIVAR","3304","HUASCO","14","15","29"
"490","ESCUELA PABLO NERUDA","3304","HUASCO","0","1","1"
"493","EDUCADOR ARTURO ALVEAR RAMOS","3302","ALTO DEL CARMEN","5","12","17"
"499","ESCUELA RICARDO CAMPILLAY CONTRERAS","3302","ALTO DEL CARMEN","13","9","22"
"516","LICEO GABRIELA MISTRAL DE LA SERENA","4101","LA SERENA","10","5","15"
"517","LICEO GREGORIO CORDOVEZ","4101","LA SERENA","22","25","47"
"519","COLEGIO ARTURO PRAT CHACON","4101","LA SERENA","30","38","68"
"521","COLEGIO VICTOR DOMINGO SILVA","4101","LA SERENA","18","15","33"
"522","COLEGIO JAVIERA CARRERA","4101","LA SERENA","40","0","40"
"523","ESCUELA ALONSO DE ERCILLA","4101","LA SERENA","18","18","36"
"525","COLEGIO JAPON","4101","LA SERENA","10","28","38"
"526","COLEGIO JOSE MANUEL BALMACEDA","4101","LA SERENA","18","21","39"
"527","COLEGIO HEROES DE LA CONCEPCION","4101","LA SERENA","10","16","26"
"528","ESCUELA GERMAN RIESCO","4101","LA SERENA","25","0","25"
"530","COLEGIO GABRIEL GONZALEZ VIDELA","4101","LA SERENA","17","33","50"
"531","COLEGIO PEDRO AGUIRRE CERDA","4101","LA SERENA","15","10","25"
"532","CEN.ED.INT.DE ADUL.ESTER VILLARREAL CASTILLO","4101","LA SERENA","24","28","52"
"533","COLEGIO DARIO SALAS","4101","LA SERENA","3","11","14"
"534","COLEGIO VILLA SAN BARTOLOME","4101","LA SERENA","13","16","29"
"535","COLEGIO JOSE MIGUEL CARRERA","4101","LA SERENA","16","20","36"
"536","COLEGIO BERNARDA MORIN","4101","LA SERENA","10","11","21"
"539","COLEGIO DE ALGARROBITO","4101","LA SERENA","3","5","8"
"540","ESCUELA DE ISLON","4101","LA SERENA","2","3","5"
"542","ESCUELA DE LAMBERT","4101","LA SERENA","5","6","11"
"543","COLEGIO ALTOVALSOL","4101","LA SERENA","2","8","10"
"546","COLEGIO COQUIMBITO","4101","LA SERENA","6","2","8"
"548","ESCUELA DE COLONIA ALFALFARES","4101","LA SERENA","2","4","6"
"551","ESCUELA DE LAS ROJAS","4101","LA SERENA","5","6","11"
"556","ESCUELA DE ROMERO","4101","LA SERENA","5","3","8"
"557","ESCUELA DE SATURNO","4101","LA SERENA","10","10","20"
"560","COLEGIO QUEBRADA DE TALCA","4101","LA SERENA","3","6","9"
"562","COLEGIO CALETA SAN PEDRO","4101","LA SERENA","4","4","8"
"578","LICEO IGNACIO CARRERA PINTO","4101","LA SERENA","2","3","5"
"597","ESCUELA BASICA PEDRO PABLO MUNOZ","4104","LA HIGUERA","9","19","28"
"599","ESCUELA JOSE SANTOS OSSA","4104","LA HIGUERA","7","11","18"
"602","ESCUELA BASICA CARLOS CONDELL","4104","LA HIGUERA","5","5","10"
"612","ESCUELA GUILLERMO CERECEDA","4102","COQUIMBO","9","10","19"
"613","COLEGIO DE ARTES CLAUDIO ARRAU","4102","COQUIMBO","23","31","54"
"614","ESCUELA PRESIDENTE ANIBAL PINTO","4102","COQUIMBO","19","29","48"
"615","ESCUELA COQUIMBO","4102","COQUIMBO","15","15","30"
"616","ESCUELA CARDENAL JOSE MARIA CARO","4102","COQUIMBO","31","43","74"
"617","COLEGIO SANTA CECILIA","4102","COQUIMBO","15","14","29"
"618","ESCUELA SANTO TOMAS DE AQUINO","4102","COQUIMBO","34","34","68"
"620","ESCUELA JOSE ALFARO ALFARO","4102","COQUIMBO","16","17","33"
"621","ESCUELA BASICA MARIO MUNOZ SILVA","4102","COQUIMBO","10","9","19"
"625","ESCUELA TOMASA OLIVARES CAAMANO","4102","COQUIMBO","12","19","31"
"626","ESCUELA BASICA DAVID LEON TAPIA","4102","COQUIMBO","33","21","54"
"628","ESCUELA DE PENUELAS","4102","COQUIMBO","15","14","29"
"629","COLEGIO PABLO NERUDA","4102","COQUIMBO","32","34","66"
"630","COLEGIO LA HERRADURA","4102","COQUIMBO","12","19","31"
"631","ESCUELA SAN RAFAEL","4102","COQUIMBO","27","12","39"
"632","ESCUELA BASICA MANUEL DE SALAS","4102","COQUIMBO","17","20","37"
"637","ESCUELA LUCILA GODOY ALCAYAGA","4102","COQUIMBO","8","17","25"
"644","ESCUELA DE PUERTO ALDEA","4102","COQUIMBO","1","1","2"
"657","ESCUELA LUIS CRUZ MARTINEZ","4103","ANDACOLLO","17","21","38"
"658","ESCUELA PATRICIO LYNCH","4103","ANDACOLLO","6","14","20"
"666","ESCUELA BASICA LUCILA GODOY ALCAYAGA","4106","VICUÑA","25","26","51"
"668","ESCUELA EDMUNDO VIDAL CARDENAS","4106","VICUÑA","13","16","29"
"669","ESCUELA NEFTALI REYES","4106","VICUÑA","7","9","16"
"671","ESCUELA RIOS DE ELQUI","4106","VICUÑA","13","14","27"
"672","ESCUELA DE DIAGUITAS JUAN TORRES M.","4106","VICUÑA","4","9","13"
"673","ESCUELA JOSE ABELARDO NUNEZ","4106","VICUÑA","10","9","19"
"680","ESCUELA FEDERICO BARNES PAYNE","4106","VICUÑA","1","4","5"
"682","ESCUELA DAGOBERTO CAMPOS NUNEZ","4106","VICUÑA","6","6","12"
"691","ESCUELA MUNICIPAL CIELO CLARO--PAIHUANO","4105","PAIGUANO","15","9","24"
"694","ESCUELA GABRIELA MISTRAL","4105","PAIGUANO","10","15","25"
"704","LICEO ALEJANDRO ALVAREZ JOFRE","4301","OVALLE","63","45","108"
"706","COLEGIO FRAY JORGE","4301","OVALLE","19","42","61"
"707","ESCUELA BASICA HELENE LANG","4301","OVALLE","53","0","53"
"708","ESCUELA ANTONIO TIRADO LANAS","4301","OVALLE","16","26","42"
"709","ESCUELA BASICA OSCAR ARAYA MOLINA","4301","OVALLE","14","15","29"
"710","ESCUELA BASICA JOSE TOMAS OVALLE B.","4301","OVALLE","10","20","30"
"711","ESCUELA GUARDIAMARINA ERNESTO RIQUELME V","4301","OVALLE","8","24","32"
"712","ESCUELA BÁSICA ARTURO ALESSANDRI PALMA","4301","OVALLE","24","36","60"
"713","ESCUELA ARTURO VILLALON SIEULANNE","4301","OVALLE","12","16","28"
"714","ESCUELA BASICA VISTA HERMOSA","4301","OVALLE","15","21","36"
"715","ESCUELA BASICA BERNARDO O¦HIGGINS RIQUELME","4301","OVALLE","6","9","15"
"716","ESC.PADRE JOSEPH BENEDIKT STEGMEIER","4301","OVALLE","8","9","17"
"718","ESCUELA MARCOS MACUADA OGALDE","4301","OVALLE","4","6","10"
"721","ESCUELA BASICA FLORENCIO ESPINOZA LOPEZ","4301","OVALLE","39","28","67"
"722","ESC. HEBERTO VELAZQUEZ VELAZQUEZ","4301","OVALLE","8","7","15"
"725","ESCUELA EL CRISOL","4301","OVALLE","5","15","20"
"729","ESCUELA BASICA LOS OLIVOS","4301","OVALLE","11","5","16"
"730","ESCUELA BASICA LUCIA NUNEZ DE LA CUADRA","4301","OVALLE","5","4","9"
"731","ESCUELA EL TRAPICHE","4301","OVALLE","1","1","2"
"733","ESCUELA PADRE DAMIAN HEREDIA","4301","OVALLE","1","4","5"
"737","ESCUELA BASICA VALENTIN LETELIER","4301","OVALLE","5","5","10"
"740","ESCUELA PEDRO ENRIQUE ALFONSO BARRIOS","4301","OVALLE","5","3","8"
"743","ESCUELA CARACHILLA","4301","OVALLE","1","1","2"
"747","ESCUELA CERRO TAMAYA","4301","OVALLE","3","8","11"
"750","ESCUELA ELVIRA DEL CARMEN OCHOA  AVILES","4301","OVALLE","4","11","15"
"753","ESC.BAS.JUAN PABLO ARTIGUES PENAFIEL","4301","OVALLE","3","12","15"
"757","ESCUELA BASICA EL GUINDO","4301","OVALLE","5","4","9"
"759","ESCUELA BASICA GASPAR CABRALES","4301","OVALLE","0","3","3"
"773","ESCUELA SAMO ALTO","4305","RIO HURTADO","4","7","11"
"774","COLEGIO PICHASCA","4305","RIO HURTADO","12","8","20"
"793","ESCUELA BASICA DE  SERON","4305","RIO HURTADO","2","3","5"
"798","ESCUELA EL PALQUI","4303","MONTE PATRIA","45","46","91"
"799","COLEGIO REPUBLICA DE CHILE","4303","MONTE PATRIA","28","30","58"
"800","ESCUELA HUATULAME","4303","MONTE PATRIA","8","12","20"
"803","ESC.CONCENTRACION FRONTERIZA DE TULAHUEN","4303","MONTE PATRIA","13","26","39"
"804","ESCUELA BASICA WENCESLAO VARGAS","4303","MONTE PATRIA","7","6","13"
"809","ESCUELA DE HUANILLA","4303","MONTE PATRIA","2","1","3"
"821","ESCUELA DE FLOR DEL VALLE","4303","MONTE PATRIA","6","10","16"
"822","ESCUELA JUNTAS","4303","MONTE PATRIA","8","5","13"
"827","COLEGIO RIO GRANDE","4303","MONTE PATRIA","12","14","26"
"833","ESCUELA SANTA BERNARDITA","4303","MONTE PATRIA","8","10","18"
"839","ESCUELA CHILECITO","4303","MONTE PATRIA","1","3","4"
"847","ESCUELA BASICA AMERICA","4302","COMBARBALA","30","29","59"
"848","ESCUELA ALEJANDRO CHELEN ROJAS","4303","MONTE PATRIA","14","21","35"
"849","ESCUELA BASICA JUANITA FERNANDEZ SOLAR","4302","COMBARBALA","7","9","16"
"850","ESCUELA JUAN LUIS SAN FUENTES","4302","COMBARBALA","1","4","5"
"851","ESCUELA BASICA ARTURO PEREZ CANTO","4302","COMBARBALA","2","2","4"
"852","ESCUELA BASICA PEDRO DE VALDIVIA","4302","COMBARBALA","6","11","17"
"870","ESCUELA BASICA CAMILO HENRIQUEZ GONZALEZ","4302","COMBARBALA","1","4","5"
"871","ESCUELA BASICA LUIS ENRIQUE BOU PEREZ","4302","COMBARBALA","0","1","1"
"876","ESCUELA BASICA CLAUDIO MATTE","4302","COMBARBALA","1","0","1"
"879","ESCUELA BASICA BENJAMIN VICUNA MACKENNA","4302","COMBARBALA","3","1","4"
"888","ESCUELA BASICA BOSQUE DE QUILLAY","4302","COMBARBALA","0","2","2"
"897","ESCUELA BELGICA","4304","PUNITAQUI","30","31","61"
"905","ESCUELA CHALINGA","4301","OVALLE","3","4","7"
"908","ESCUELA TABALI","4301","OVALLE","5","5","10"
"910","ESC.BASICA SAN ANTONIO DE LA VILLA","4301","OVALLE","0","5","5"
"915","ESCUELA MARCOS RIGOBERTO  PIZARRO ARAYA","4301","OVALLE","5","4","9"
"929","ESCUELA LOS NOGALES","4301","OVALLE","4","6","10"
"932","ESCUELA UNION CAMPESINA","4301","OVALLE","7","4","11"
"937","ESCUELA ALCONES BAJOS","4301","OVALLE","6","1","7"
"945","ESCUELA SOL NACIENTE","4304","PUNITAQUI","2","3","5"
"946","ESCUELA TERESITA DE LOS ANDES","4304","PUNITAQUI","5","10","15"
"947","ESCUELA AURORA DE CHILE","4301","OVALLE","4","4","8"
"953","ESCUELA PATRICIO ZEBALLOS","4301","OVALLE","7","10","17"
"964","ESCUELA BASICA MUNICIPAL DE ADULTOS","4201","ILLAPEL","4","6","10"
"967","LICEO DOMINGO ORTIZ DE ROZAS","4201","ILLAPEL","8","7","15"
"969","ESCUELA BASICA VALLE DEL CHOAPA","4201","ILLAPEL","28","30","58"
"970","ESCUELA JUAN CARRASCO RISCO","4201","ILLAPEL","5","12","17"
"971","ESCUELA BASICA SAN RAFAEL DE ROZAS","4201","ILLAPEL","31","0","31"
"972","ESCUELA BASICA JORGE ARACENA RAMOS","4201","ILLAPEL","11","17","28"
"973","ESCUELA BASICA CLEMENCIA VILLARROEL","4201","ILLAPEL","2","8","10"
"974","ESCUELA BASICA CAMILO HENRIQUEZ","4201","ILLAPEL","2","7","9"
"976","ESCUELA BASICA LAS PALMERAS DE LIMAHUIDA","4201","ILLAPEL","8","8","16"
"977","ESCUELA BASICA GRACIELA DIAZ ALLENDE","4201","ILLAPEL","2","2","4"
"982","ESCUELA BASICA VILLA LOS NARANJOS","4201","ILLAPEL","15","28","43"
"1013","LICEO DE SALAMANCA","4204","SALAMANCA","10","6","16"
"1014","ESCUELA MATILDE SALAMANCA","4204","SALAMANCA","18","21","39"
"1015","ESCUELA BASICA DIAGUITAS DE CHALINGA","4204","SALAMANCA","10","9","19"
"1016","ESCUELA TRANQUILLA","4204","SALAMANCA","5","4","9"
"1017","ESCUELA BASICA BERTA HIDALGO BARAHONA","4204","SALAMANCA","3","4","7"
"1018","ESCUELA EL TAMBO","4204","SALAMANCA","3","7","10"
"1019","ESCUELA BASICA  CHILLEPIN","4204","SALAMANCA","11","12","23"
"1020","ESCUELA BASICA GUISELA GAMBOA SALINAS","4204","SALAMANCA","9","10","19"
"1022","ESCUELA COIRON","4204","SALAMANCA","1","2","3"
"1031","ESCUELA BASICA JULIO ECHAVARRIA","4204","SALAMANCA","8","3","11"
"1032","ESCUELA BASICA SAN AGUSTIN","4204","SALAMANCA","0","1","1"
"1033","ESCUELA BASICA PANGUESILLO","4204","SALAMANCA","2","4","6"
"1034","ESCUELA LOS CORRALES","4204","SALAMANCA","2","3","5"
"1049","COLEGIO DIEGO DE ALMAGRO","4203","LOS VILOS","27","28","55"
"1050","ESCUELA BASICA ERCOLE BENCINI","4203","LOS VILOS","3","20","23"
"1051","ESCUELA BASICA TERESA CANNON DE B.","4203","LOS VILOS","23","17","40"
"1052","ESCUELA BASICA PABLO BARRIOLHET","4203","LOS VILOS","8","7","15"
"1059","ESCUELA CLARA VIAL ORREGO","4203","LOS VILOS","9","9","18"
"1077","ESCUELA MUNICIPAL CANELA BAJA","4202","CANELA","33","16","49"
"1078","ESCUELA BASICA JUAN ANTONIO RIOS","4202","CANELA","6","5","11"
"1087","ESCUELA BASICA CANELA ALTA","4202","CANELA","16","26","42"
"1092","ESCUELA BASICA MINCHA NORTE","4202","CANELA","2","2","4"
"1099","ESCUELA VIOLETA PARRA","4202","CANELA","2","2","4"
"1100","ESC.BASICA CARLOS VIAL ESPANTOSO","4202","CANELA","4","3","7"
"1120","CENTRO DE EDUCACION DE ADULTOS LA LIGUA","5401","LA LIGUA","0","2","2"
"1122","ESCUELA REPUBLICA DE VENEZUELA","5401","LA LIGUA","8","26","34"
"1123","ESCUELA GABRIELA MISTRAL","5401","LA LIGUA","33","28","61"
"1125","ESCUELA DIEGO PORTALES","5401","LA LIGUA","6","11","17"
"1128","ESCUELA COMUNIDADES DE VALLE HERMOSO","5401","LA LIGUA","16","18","34"
"1132","ESCUELA BASICA POZA VERDE","5401","LA LIGUA","12","7","19"
"1136","ESCUELA BASICA PUYANCON","5401","LA LIGUA","7","7","14"
"1142","ESCUELA LA CANELA","5401","LA LIGUA","2","5","7"
"1145","ESCUELA ENRIQUE DOLL ROJAS","5401","LA LIGUA","4","4","8"
"1147","ESCUELA FERNANDO GARCIA OLDINI","5404","PETORCA","9","7","16"
"1148","LICEO JOSE MANUEL BORGONO NUNEZ","5404","PETORCA","10","18","28"
"1149","LICEO CORDILLERA","5404","PETORCA","7","11","18"
"1156","ESCUELA BASICA G-24","5404","PETORCA","4","1","5"
"1161","ESCUELA BASICA PEDEGUA","5404","PETORCA","5","9","14"
"1168","ESCUELA HANS WENKE MENGERS","5402","CABILDO","27","28","55"
"1170","ESCUELA BASICA VALLE DE ARTIFICIO","5402","CABILDO","8","6","14"
"1173","ESCUELA ESTER SILVA SOMARRIVA BARTOLILLO","5402","CABILDO","10","6","16"
"1174","ESCUELA BASICA SAN LORENZO","5402","CABILDO","2","9","11"
"1178","ESCUELA BASICA LA VINA","5402","CABILDO","9","6","15"
"1180","ESCUELA BASICA G-45","5402","CABILDO","11","16","27"
"1183","LICEO DE ZAPALLAR","5405","ZAPALLAR","15","13","28"
"1184","ESCUELA BASICA MERCEDES MATURANA GALLARDO","5405","ZAPALLAR","15","16","31"
"1185","ESCUELA BALNEARIO CACHAGUA","5405","ZAPALLAR","5","6","11"
"1191","ESCUELA PAPUDO","5403","PAPUDO","7","18","25"
"1192","ESCUELA RURAL PULLALLY","5403","PAPUDO","7","8","15"
"1194","LICEO MAXIMILIANO SALAS MARCHAN","5301","LOS ANDES","25","19","44"
"1197","ESCUELA ESPANA","5301","LOS ANDES","25","37","62"
"1198","LICEO REPUBLICA ARGENTINA","5301","LOS ANDES","10","9","19"
"1200","ESCUELA JOHN KENNEDY","5301","LOS ANDES","9","10","19"
"1202","ESCUELA FERROVIARIA","5301","LOS ANDES","16","20","36"
"1203","ESCUELA GABRIELA MISTRAL","5301","LOS ANDES","11","11","22"
"1204","ESCUELA BASICA GRAL.JOSE MIGUEL CARRERA","5301","LOS ANDES","10","11","21"
"1206","C.E.I.A  DR. OSVALDO ROJAS GONZALEZ","5301","LOS ANDES","12","11","23"
"1208","ESCUELA BASICA RIO BLANCO","5301","LOS ANDES","9","6","15"
"1210","ESCUELA EL SAUCE","5301","LOS ANDES","12","15","27"
"1211","ESCUELA IGNACIO CARRERA PINTO","5301","LOS ANDES","18","21","39"
"1233","ESCUELA PABLO NERUDA","5304","SAN ESTEBAN","19","24","43"
"1234","ESC. BASICA SILVIO ZENTENO VERGARA","5304","SAN ESTEBAN","8","14","22"
"1235","ESCUELA LO CALVO","5304","SAN ESTEBAN","8","12","20"
"1238","ESCUELA INCLUSIVA SAN LORENZO","5304","SAN ESTEBAN","1","2","3"
"1245","ESCUELA EL CORAZON","5304","SAN ESTEBAN","8","14","22"
"1246","ESCUELA BÁSICA LIBERTAD","5304","SAN ESTEBAN","7","8","15"
"1247","ESCUELA BASICA MARIA ISABEL DE BROWN","5302","CALLE LARGA","5","5","10"
"1248","ESCUELA BASICA LA PAMPILLA","5302","CALLE LARGA","12","15","27"
"1250","ESCUELA VICTOR KOERNER","5302","CALLE LARGA","3","6","9"
"1251","ESCUELA BASICA CRISTO REDENTOR","5302","CALLE LARGA","12","7","19"
"1257","ESCUELA PERFECTO DE LA FUENTE DEL VILLAR","5303","RINCONADA","32","33","65"
"1261","LICEO DOCTOR ROBERTO HUMERES O.","5701","SAN FELIPE","3","10","13"
"1263","LICEO DE NINAS CORINA URBINA","5701","SAN FELIPE","53","0","53"
"1264","LICEO SAN FELIPE","5701","SAN FELIPE","7","14","21"
"1265","ESCUELA BASICA BERNARDO O HIGGINS R.","5701","SAN FELIPE","11","18","29"
"1266","ESCUELA MANUEL RODRIGUEZ ERDOIZA","5701","SAN FELIPE","3","3","6"
"1268","ESCUELA BASICA JOSE DE SAN MARTIN","5701","SAN FELIPE","54","58","112"
"1269","ESCUELA JOHN F KENNEDY","5701","SAN FELIPE","11","9","20"
"1271","ESCUELA JOSÉ ANTONIO MANSO DE VELASCO","5701","SAN FELIPE","14","13","27"
"1274","ESCUELA ALMENDRAL","5701","SAN FELIPE","7","15","22"
"1275","ESCUELA BUEN PASTOR","5701","SAN FELIPE","20","20","40"
"1279","ESCUELA CARMELA CARVAJAL DE PRAT","5701","SAN FELIPE","9","6","15"
"1280","ESCUELA 21 DE MAYO","5701","SAN FELIPE","3","16","19"
"1281","ESCUELA REPUBLICA ARGENTINA","5701","SAN FELIPE","6","11","17"
"1282","ESCUELA BUCALEMITO","5701","SAN FELIPE","4","10","14"
"1285","ESCUELA MATEO COKLJAT K","5701","SAN FELIPE","4","6","10"
"1287","ESCUELA JOSE BERNARDO SUAREZ","5701","SAN FELIPE","4","7","11"
"1301","LICEO MANUEL MARIN","5705","PUTAENDO","16","14","30"
"1302","LICEO   REPUBLICA DE ESTADOS UNIDOS","5705","PUTAENDO","4","9","13"
"1304","ESCUELA PASO HISTORICO EL TARTARO","5705","PUTAENDO","5","10","15"
"1305","ESCUELA RENACER","5705","PUTAENDO","11","5","16"
"1307","ESCUELA SAN ALBERTO","5705","PUTAENDO","5","14","19"
"1313","ESCUELA CATAN DABIKE","5705","PUTAENDO","6","8","14"
"1318","LICEO DARIO SALAS","5706","SANTA MARIA","13","13","26"
"1321","ESCUELA GUILLERMO BANADOS HONORATO","5706","SANTA MARIA","13","8","21"
"1328","ESCUELA INDEPENDENCIA","5704","PANQUEHUE","5","6","11"
"1329","ESCUELA EMA LOBOS REYES","5704","PANQUEHUE","12","9","21"
"1333","ESCUELA JORGE BARROS BEAUCHEF","5704","PANQUEHUE","5","9","14"
"1336","ESCUELA AGUSTIN EDWARDS","5703","LLAILLAY","29","39","68"
"1337","ESCUELA HEROES DE IQUIQUE","5703","LLAILLAY","7","12","19"
"1338","ESCUELA NACIONES UNIDAS","5703","LLAILLAY","10","12","22"
"1339","ESCUELA ELISA LATTAPIAT VARGAS","5703","LLAILLAY","13","16","29"
"1340","ESCUELA HERMINIA ORTEGA DE CROXATO","5703","LLAILLAY","9","10","19"
"1341","ESCUELA BASICA EL PORVENIR","5703","LLAILLAY","8","16","24"
"1346","ESCUELA JORGE PRIETO LETELIER","5703","LLAILLAY","2","2","4"
"1352","ESCUELA MARIA TERESA DEL CANTO","5702","CATEMU","13","17","30"
"1353","ESCUELA SAN JOSE DE CATEMU","5702","CATEMU","8","3","11"
"1355","ESCUELA EL COBRE","5702","CATEMU","8","10","18"
"1358","ESCUELA BASICA EL NILHUE","5702","CATEMU","6","12","18"
"1359","ESCUELA BASICA LOS CERRILLOS","5702","CATEMU","5","9","14"
"1364","COLEGIO VALLE DE QUILLOTA","5501","QUILLOTA","20","18","38"
"1366","LICEO COMERCIAL DE QUILLOTA","5501","QUILLOTA","19","8","27"
"1367","COLEGIO ROBERTO MATTA","5501","QUILLOTA","27","0","27"
"1368","ESCUELA BASICA CANADA","5501","QUILLOTA","51","0","51"
"1369","ESCUELA BASICA ABRAHAM LINCOLN","5501","QUILLOTA","5","16","21"
"1370","ESCUELA BASICA REPUBLICA DE MEXICO","5501","QUILLOTA","17","23","40"
"1371","ESCUELA BASICA ARAUCO","5501","QUILLOTA","31","36","67"
"1376","ESCUELA BASICA RAMON FREIRE","5501","QUILLOTA","12","21","33"
"1377","ESCUELA NUESTRO MUNDO","5501","QUILLOTA","10","15","25"
"1378","ESCUELA BASICA ABEL GUERRERO AGUIRRE","5501","QUILLOTA","12","9","21"
"1384","COLEGIO CUMBRES DE BOCO","5501","QUILLOTA","6","11","17"
"1385","ESCUELA BASICA LA PALMA","5501","QUILLOTA","5","21","26"
"1390","ESCUELA BASICA LAS PATAGUAS","5501","QUILLOTA","2","5","7"
"1414","COLEGIO LEONARDO DA VINCI","5504","LA CRUZ","11","13","24"
"1416","COLEGIO MARIA ALONSO CHACON","5504","LA CRUZ","10","12","22"
"1417","COLEGIO BOLONIA","5504","LA CRUZ","12","10","22"
"1423","ESCUELA BASICA JOSEFINA HUICI","5502","CALERA","6","6","12"
"1424","ESCUELA BASICA IRMA SAPIAIN","5502","CALERA","16","15","31"
"1425","COMPLEJO EDUCACIONAL LAS ACACIAS DE ARTIFICIO","5502","CALERA","21","22","43"
"1427","ESCUELA BASICA PALESTINA","5502","CALERA","8","11","19"
"1430","ESCUELA BASICA GABRIELA MISTRAL","5502","CALERA","11","12","23"
"1431","ESCUELA BASICA SANTA ROSA DEL HUERTO","5502","CALERA","9","16","25"
"1433","ESCUELA BASICA EL LIBERTADOR","5502","CALERA","3","14","17"
"1435","ESCUELA BASICA VILLA LA FLORIDA","5502","CALERA","5","4","9"
"1444","LICEO MUNICIPAL JUAN RUSQUE PORTAL","5506","NOGALES","10","20","30"
"1445","ESCUELA BASICA EL MELON","5506","NOGALES","24","11","35"
"1447","ESCUELA BASICA ULDA ARACENA GONZALEZ","5506","NOGALES","16","24","40"
"1448","ESCUELA BASICA LA PENA","5506","NOGALES","2","5","7"
"1453","LICEO MUNICIPAL LUIS LABORDA","5503","HIJUELAS","35","28","63"
"1454","ESCUELA ADRIANA RIQUELME NUNEZ","5503","HIJUELAS","4","14","18"
"1455","ESCUELA MONICA HURTADO EDWARDS","5503","HIJUELAS","7","5","12"
"1456","ESCUELA ANA JESUS IBACACHE","5503","HIJUELAS","4","5","9"
"1457","ESCUELA BASICA BENJAMIN MATTE LARRAIN","5503","HIJUELAS","0","9","9"
"1458","ESCUELA BASICA LA SOMBRA","5503","HIJUELAS","5","8","13"
"1459","ESCUELA BASICA RABUCO","5503","HIJUELAS","4","4","8"
"1465","ESCUELA COEDUC TTE HERNAN MERINO CORREA","5802","LIMACHE","17","17","34"
"1466","ESCUELA SUPERIOR MIXTA Nº 88","5802","LIMACHE","21","29","50"
"1468","ESCUELA BASICA BRASILIA","5802","LIMACHE","6","18","24"
"1469","ESCUELA BASICA HEROES DE CHILE","5802","LIMACHE","15","20","35"
"1471","ESCUELA LIMACHITO","5802","LIMACHE","2","9","11"
"1472","ESCUELA BASICA LOS MAITENES","5802","LIMACHE","4","13","17"
"1474","ESCUELA BASICA PUENTE COLMO","5103","CONCON","5","18","23"
"1488","ESCUELA MONTEVIDEO","5803","OLMUE","19","19","38"
"1490","ESCUELA BÁSICA QUEBRADA DE ALVARADO","5803","OLMUE","2","8","10"
"1491","ESCUELA BASICA LO NARVAEZ","5803","OLMUE","4","9","13"
"1496","ESCUELA LAS PALMAS DEL NIÑO DIOS","5803","OLMUE","5","6","11"
"1498","ESCUELA LAS BELLOTAS DE LA VEGA","5803","OLMUE","3","2","5"
"1504","LICEO TÉCNICO DE VALPARAÍSO","5101","VALPARAISO","1","2","3"
"1506","CENTRO EDUCATIVO FLORIDA","5101","VALPARAISO","4","4","8"
"1511","CENTRO EDUCATIVO REINO DE SUECIA","5101","VALPARAISO","2","5","7"
"1514","ESCUELA  HERNAN OLGUIN","5101","VALPARAISO","12","18","30"
"1515","LICEO EDUARDO DE LA BARRA","5101","VALPARAISO","22","34","56"
"1516","LICEO TECNOLÓGICO ALFREDO NAZAR FERES","5101","VALPARAISO","14","16","30"
"1517","LICEO MATILDE BRANDAU DE ROSS","5101","VALPARAISO","16","19","35"
"1518","LICEO MARIA LUISA BOMBAL","5101","VALPARAISO","10","8","18"
"1519","LICEO TECNICO PROFESIONAL BARON","5101","VALPARAISO","4","3","7"
"1520","LICEO BICENTENARIO MARITIMO DE VALPARAISO","5101","VALPARAISO","32","22","54"
"1521","LICEO DE NINAS MARIA FRANCK DE MACDOUGAL","5101","VALPARAISO","29","0","29"
"1522","COLEGIO PEDRO MONTT","5101","VALPARAISO","8","5","13"
"1523","ESCUELA NACIONES UNIDAS","5101","VALPARAISO","32","16","48"
"1524","ESCUELA REPUBLICA ARABE SIRIA","5101","VALPARAISO","7","5","12"
"1526","ESCUELA REPUBLICA DEL PARAGUAY","5101","VALPARAISO","6","17","23"
"1528","ESCUELA  GASPAR CABRALES","5101","VALPARAISO","13","34","47"
"1529","ESCUELA GRECIA","5101","VALPARAISO","0","35","35"
"1533","ESCUELA ALEMANIA","5101","VALPARAISO","0","68","68"
"1534","ESCUELA REPUBLICA DEL URUGUAY","5101","VALPARAISO","70","0","70"
"1536","ESCUELA AMERICA","5101","VALPARAISO","38","35","73"
"1537","ESCUELA RAMON BARROS LUCO","5101","VALPARAISO","41","0","41"
"1538","ESCUELA JUAN JOSE LATORRE B","5101","VALPARAISO","8","9","17"
"1540","ESCUELA BLAS CUEVAS RAMON ALLENDE","5101","VALPARAISO","1","7","8"
"1541","ESCUELA REPUBLICA DE EL SALVADOR","5101","VALPARAISO","7","9","16"
"1542","ESCUELA JOAQUIN EDWARDS BELLO","5101","VALPARAISO","18","21","39"
"1543","ESCUELA JORGE ALESSANDRI RODRIGUEZ","5101","VALPARAISO","7","9","16"
"1547","ESCUELA CARABINERO PEDRO A.CARIAGA M.","5101","VALPARAISO","8","13","21"
"1548","ESCUELA DIEGO PORTALES PALAZUELOS","5101","VALPARAISO","2","8","10"
"1549","ESCUELA REPUBLICA DE MEXICO","5101","VALPARAISO","29","34","63"
"1550","ESCUELA PACIFICO","5101","VALPARAISO","6","9","15"
"1551","ESCUELA MONTEDONICO","5101","VALPARAISO","4","11","15"
"1553","ESCUELA ESPANA","5101","VALPARAISO","19","21","40"
"1554","COLEGIO PABLO NERUDA","5101","VALPARAISO","10","16","26"
"1555","ESCUELA REPUBLICA DE ISRAEL","5101","VALPARAISO","8","11","19"
"1556","ESCUELA ELEUTERIO RAMIREZ","5101","VALPARAISO","8","13","21"
"1557","ESCUELA VILLA BERLIN","5101","VALPARAISO","7","9","16"
"1563","ESCUELA JUAN WACQUEZ MOURFIN","5101","VALPARAISO","3","6","9"
"1567","ESCUELA BASICA DAVID BEN GURION","5101","VALPARAISO","6","15","21"
"1568","ESCUELA REPUBLICA ARGENTINA","5101","VALPARAISO","7","14","21"
"1569","ESCUELA  PILOTO 1° LUIS PARDO VILLALON","5101","VALPARAISO","20","24","44"
"1570","ESCUELA BASICA CIRUJANO VIDELA","5101","VALPARAISO","19","24","43"
"1571","ESCUELA SAN JUDAS TADEO","5101","VALPARAISO","6","10","16"
"1573","ESCUELA  DR. ERNESTO QUIROZ WEBER","5101","VALPARAISO","12","10","22"
"1577","ESCUELA BASICA LAGUNA VERDE","5101","VALPARAISO","12","18","30"
"1666","C.E.I.A. LOS CASTANOS","5109","VIÑA DEL MAR","10","8","18"
"1667","ESCUELA ESPECIAL ADOLFO TANNENBAUM  B.","5109","VIÑA DEL MAR","9","18","27"
"1676","LICEO BICENTENARIO DE VIÑA DEL MAR","5109","VIÑA DEL MAR","12","16","28"
"1677","ESCUELA BASICA REPUBLICA DEL ECUADOR","5109","VIÑA DEL MAR","63","0","63"
"1678","ESCUELA UNESCO","5109","VIÑA DEL MAR","11","6","17"
"1680","ESCUELA ORLANDO PENA CARVAJAL","5109","VIÑA DEL MAR","12","9","21"
"1681","COLEGIO REPUBLICA DE COLOMBIA","5109","VIÑA DEL MAR","24","0","24"
"1682","COLEGIO MIRAFLORES","5109","VIÑA DEL MAR","37","37","74"
"1683","ESCUELA BASICA SANTA JULIA","5109","VIÑA DEL MAR","21","27","48"
"1684","ESCUELA LIBERTADOR  BERNARDO O^HIGGINS","5109","VIÑA DEL MAR","29","26","55"
"1685","ESCUELA DR. OSCAR MARIN SOCIAS","5109","VIÑA DEL MAR","17","20","37"
"1686","ESCUELA TEODORO LOWEY","5109","VIÑA DEL MAR","13","9","22"
"1688","ESCUELA ALMIRANTE LUIS GOMEZ CARRENO","5109","VIÑA DEL MAR","20","16","36"
"1689","ESCUELA ORO NEGRO","5103","CONCON","8","25","33"
"1691","ESCUELA LORD COCHRANE","5109","VIÑA DEL MAR","1","10","11"
"1692","ESCUELA ARTURO PRAT CHACON","5109","VIÑA DEL MAR","15","19","34"
"1693","ESCUELA BASICA 21 DE MAYO","5109","VIÑA DEL MAR","9","8","17"
"1695","ESCUELA PEDRO AGUIRRE CERDA","5109","VIÑA DEL MAR","10","12","22"
"1696","ESCUELA BASICA CHORRILOS","5109","VIÑA DEL MAR","7","9","16"
"1697","ESCUELA GASTON OSSA SAINT MARIE","5109","VIÑA DEL MAR","11","7","18"
"1698","ESCUELA PAUL HARRIS","5109","VIÑA DEL MAR","23","29","52"
"1699","ESCUELA BASICA IRMA SALAS SILVA","5103","CONCON","21","25","46"
"1700","ESCUELA DOCTOR ADRIANO MACHADO PARDO","5109","VIÑA DEL MAR","9","11","20"
"1701","ESCUELA LA PARVA","5109","VIÑA DEL MAR","6","8","14"
"1702","ESCUELA CANAL BEAGLE","5109","VIÑA DEL MAR","15","13","28"
"1703","ESCUELA PRESIDENTE JOSE MANUEL BALMACEDA","5109","VIÑA DEL MAR","12","9","21"
"1704","ESCUELA BASICA JOHN KENNEDY","5109","VIÑA DEL MAR","8","16","24"
"1705","ESCUELA PRESIDENTE SALVADOR ALLENDE","5109","VIÑA DEL MAR","14","17","31"
"1707","ESCUELA MINISTRO ZENTENO","5109","VIÑA DEL MAR","29","45","74"
"1708","ESCUELA ENRIQUE CARDENAS RIVERA","5109","VIÑA DEL MAR","7","21","28"
"1709","ESCUELA PATRICIO LYNCH Z.","5109","VIÑA DEL MAR","6","15","21"
"1710","CENTRO DE EDUCACION DE ADULTOS","5109","VIÑA DEL MAR","3","10","13"
"1712","ESCUELA VILLA MONTE","5109","VIÑA DEL MAR","13","13","26"
"1714","ESCUELA SANTA MARIA DE AGUA SANTA","5109","VIÑA DEL MAR","2","5","7"
"1716","ESCUELA VILLA INDEPENDENCIA","5109","VIÑA DEL MAR","22","15","37"
"1717","ESCUELA CARDENAL JOSE MARIA CARO","5109","VIÑA DEL MAR","14","11","25"
"1718","ESCUELA EDUARDO LEZANA PINCHEIRA","5109","VIÑA DEL MAR","11","18","29"
"1720","ESCUELA  MARCELA PAZ","5109","VIÑA DEL MAR","7","10","17"
"1721","ESCUELA BASICA REPUBLICA DEL LIBANO","5109","VIÑA DEL MAR","4","12","16"
"1722","ESCUELA BASICA DR ALDO FRANCIA BOIDO","5109","VIÑA DEL MAR","13","0","13"
"1724","ESCUELA PRESIDENTE EDUARDO FREI MONTALVA","5109","VIÑA DEL MAR","15","12","27"
"1728","ESCUELA BASICA LUISA NIETO DE HAMEL","5109","VIÑA DEL MAR","1","6","7"
"1732","ESCUELA VIOLETA PARRA","5109","VIÑA DEL MAR","5","5","10"
"1851","LICEO POLITECNICO QUINTERO","5107","QUINTERO","12","10","22"
"1853","COLEGIO COSTA MAUCO","5107","QUINTERO","12","19","31"
"1855","ESCUELA BASICA REPUBLICA DE FRANCIA","5107","QUINTERO","22","39","61"
"1856","ESCUELA MANTAGUA","5107","QUINTERO","4","11","15"
"1863","COLEGIO GENERAL JOSE VELASQUEZ BORQUEZ","5105","PUCHUNCAVI","20","20","40"
"1864","COMPLEJO EDUCACIONAL SARGENTO ALDEA","5105","PUCHUNCAVI","11","19","30"
"1867","ESCUELA LA GREDA","5105","PUCHUNCAVI","10","11","21"
"1868","ESCUELA LA CHOCOTA","5105","PUCHUNCAVI","13","16","29"
"1871","ESCUELA BASICA EL RINCON","5105","PUCHUNCAVI","2","3","5"
"1873","ESCUELA HORCON","5105","PUCHUNCAVI","6","7","13"
"1874","ESCUELA BASICA LA LAGUNA","5105","PUCHUNCAVI","6","4","10"
"1875","ESCUELA MAITENCILLO","5105","PUCHUNCAVI","7","4","11"
"1881","ESCUELA LUIS CRUZ MARTINEZ","5801","QUILPUE","29","22","51"
"1885","COLEGIO CAPITAN IGNACIO CARRERA PINTO","5801","QUILPUE","3","1","4"
"1886","ESCUELA MANUEL BULNES PRIETO","5801","QUILPUE","20","15","35"
"1887","ESCUELA GUARDIAMARINA GUILLERMO ZANARTU I.","5801","QUILPUE","22","27","49"
"1888","ESC.CDTE. ELEUTERIO RAMIREZ MOLINA","5801","QUILPUE","18","15","33"
"1889","COLEGIO FERNANDO DURAN VILLARREAL","5801","QUILPUE","21","28","49"
"1890","COLEGIO JOSE MIGUEL INFANTE","5801","QUILPUE","13","5","18"
"1891","ESCUELA BASICA JORGE ROCK LARA","5801","QUILPUE","13","11","24"
"1892","ESCUELA BASICA GASPAR CABRALES","5801","QUILPUE","10","18","28"
"1893","ESCUELA BASICA DARIO SALAS","5801","QUILPUE","5","13","18"
"1894","CENTRO DE EDUCACION DE ADULTOS","5801","QUILPUE","18","18","36"
"1895","LICEO TECNICO PROFESIONAL MANNHEIM","5801","QUILPUE","13","15","28"
"1898","ESCUELA THEODOR HEUSS","5801","QUILPUE","7","12","19"
"1899","ESCUELA TENIENTE IGNACIO SERRANO MONTANER","5801","QUILPUE","14","8","22"
"1901","ESCUELA SANTIAGO BUERAS","5801","QUILPUE","1","3","4"
"1903","ESCUELA VICENTE EDWARDS PINTO","5801","QUILPUE","3","2","5"
"1958","LICEO TECNOLOGICO VILLA ALEMANA","5804","VILLA ALEMANA","6","8","14"
"1959","WINDMILL COLLEGE","5804","VILLA ALEMANA","15","25","40"
"1961","ESCUELA LATINA INES GALLARDO ORELLANA","5804","VILLA ALEMANA","25","18","43"
"1963","ESCUELA BASICA DIEGO BARROS ARANA","5804","VILLA ALEMANA","18","12","30"
"1965","COLEGIO ITALO COMPOSTO SCARPATI","5804","VILLA ALEMANA","13","7","20"
"1966","ESCUELA BASICA CATALUNYA","5804","VILLA ALEMANA","23","16","39"
"1967","LICEO BICENTENARIO TÉCNICO PROFESIONAL MARY GRAHAM","5804","VILLA ALEMANA","49","51","100"
"1968","ESCUELA MELVIN JONES","5804","VILLA ALEMANA","7","14","21"
"1969","COLEGIO CHARLES DARWIN","5804","VILLA ALEMANA","18","19","37"
"1970","ESCUELA DIEGO PORTALES","5804","VILLA ALEMANA","9","22","31"
"1971","ESCUELA MANUEL MONTT","5804","VILLA ALEMANA","22","18","40"
"1975","ESCUELA JUAN BAUTISTA ALBERDI","5804","VILLA ALEMANA","16","16","32"
"1997","ESCUELA DOMINGO ORTIZ DE ROZAS","5102","CASABLANCA","17","15","32"
"1998","ESCUELA ARTURO ECHAZARRETA LARRAIN","5102","CASABLANCA","24","11","35"
"1999","ESCUELA MANUEL BRAVO REYES","5102","CASABLANCA","26","17","43"
"2003","ESCUELA  SAN PEDRO DE QUINTAY","5102","CASABLANCA","2","3","5"
"2005","ESCUELA BASICA LAGUNILLAS","5102","CASABLANCA","5","4","9"
"2009","COLEGIO INSULAR ROBINSON CRUSOE","5104","JUAN FERNANDEZ","3","3","6"
"2014","ESCUELA POETA PABLO NERUDA","5601","SAN ANTONIO","11","15","26"
"2017","ESCUELA VILLA LAS DUNAS","5601","SAN ANTONIO","5","8","13"
"2018","ESCUELA MOVILIZADORES PORTUARIOS","5601","SAN ANTONIO","27","62","89"
"2019","COLEGIO ESPANA","5601","SAN ANTONIO","9","19","28"
"2020","ESCUELA PRESIDENTE PEDRO AGUIRRE CERDA","5601","SAN ANTONIO","15","10","25"
"2021","PADRE ANDRE COINDRE","5601","SAN ANTONIO","26","38","64"
"2022","ESCUELA BASICA SAN JOSE DE CALASANZ","5601","SAN ANTONIO","5","5","10"
"2023","ESCUELA CRISTO DEL MAIPO","5601","SAN ANTONIO","6","3","9"
"2024","PROFESOR PEDRO VIVEROS ORMENO","5601","SAN ANTONIO","2","5","7"
"2026","ESCUELA BASICA CERRO PLACILLA","5601","SAN ANTONIO","15","28","43"
"2027","ESCUELA POETA HUIDOBRO","5601","SAN ANTONIO","8","8","16"
"2035","ESCUELA BASICA CUNCUMEN","5601","SAN ANTONIO","6","3","9"
"2036","ESCUELA BASICA LEYDA","5601","SAN ANTONIO","6","6","12"
"2037","EDUARDO FERNANDEZ DE ASTURIAS","5601","SAN ANTONIO","2","4","6"
"2065","ESCUELA PRESIDENTE AGUIRRE CERDA","5603","CARTAGENA","36","48","84"
"2066","LICEO EUGENIA SUBERCASEAUX","5603","CARTAGENA","21","15","36"
"2068","ESCUELA CARMEN ROMERO AGUIRRE","5603","CARTAGENA","8","9","17"
"2074","ESCUELA BASICA LAS CRUCES","5605","EL TABO","16","17","33"
"2075","COLEGIO EL TABO","5605","EL TABO","10","26","36"
"2078","COMPLEJO EDUCACIONAL CLARA SOLOVERA","5604","EL QUISCO","16","17","33"
"2079","ESCUELA POETA NERUDA DE ISLA NEGRA","5604","EL QUISCO","21","23","44"
"2081","ESCUELA EL TOTORAL","5604","EL QUISCO","8","22","30"
"2084","COLEGIO CARLOS ALESSANDRI ALTAMIRANO","5602","ALGARROBO","26","34","60"
"2085","ESCUELA BASICA RURAL EL YECO","5602","ALGARROBO","5","14","19"
"2091","COLEGIO PEOPLE HELP PEOPLE","5606","SANTO DOMINGO","30","39","69"
"2092","ESCUELA EL CONVENTO","5606","SANTO DOMINGO","5","6","11"
"2096","ESCUELA BASICA CLAUDIO VICUNA","5606","SANTO DOMINGO","2","3","5"
"2101","COLEGIO BASICO LORENZO BAEZA VEGA","5201","ISLA DE PASCUA","0","1","1"
"2109","LICEO DE NIÑAS DE RANCAGUA","6101","RANCAGUA","22","0","22"
"2110","LICEO MUNICIPAL OSCAR CASTRO ZUNIGA","6101","RANCAGUA","180","106","286"
"2112","ESCUELA MUNICIPAL MOISES MUSSA","6101","RANCAGUA","0","125","125"
"2114","ESCUELA MUNICIPAL MARCELA PAZ","6101","RANCAGUA","138","0","138"
"2115","ESCUELA MUNICIPAL RENE SCHNEIDER CHEREAU","6101","RANCAGUA","10","15","25"
"2116","COLEGIO MUNICIPAL EDUARDO DE GEYTER","6101","RANCAGUA","27","51","78"
"2118","COLEGIO ESPANA","6101","RANCAGUA","23","37","60"
"2119","ESCUELA MUNICIPAL MANUEL RODRIGUEZ","6101","RANCAGUA","12","16","28"
"2120","ESCUELA MUNICIPAL MINERAL EL TENIENTE","6101","RANCAGUA","35","61","96"
"2121","COLEGIO REPUBLICA ARGENTINA","6101","RANCAGUA","122","0","122"
"2122","ESCUELA MUNICIPAL EL COBRE","6101","RANCAGUA","17","28","45"
"2123","INSTITUTO TECNOLOGICO MINERO BERNARDO OHIGGINS","6101","RANCAGUA","12","24","36"
"2124","LICEO INTEGRADO LIBERTADOR SIMÓN BOLIVAR","6101","RANCAGUA","24","37","61"
"2125","COLEGIO PABLO GARRIDO","6101","RANCAGUA","12","14","26"
"2126","COL. JOSE A. MANSO DE VELASCO Y S.","6101","RANCAGUA","19","15","34"
"2129","COLEGIO AURORA DE CHILE","6101","RANCAGUA","33","39","72"
"2131","ESCUELA MUNICIPAL CARLOS MIRANDA MIRANDA","6101","RANCAGUA","12","13","25"
"2132","ESCUELA MUNICIPAL PATRICIO MEKIS","6101","RANCAGUA","18","15","33"
"2135","ESCUELA MUNICIPAL JEAN PIAGET","6101","RANCAGUA","18","21","39"
"2136","ESCUELA MUNICIPAL ISABEL RIQUELME","6101","RANCAGUA","10","13","23"
"2138","ESCUELA MUNICIPAL ALBERTO BLEST GANA","6101","RANCAGUA","9","7","16"
"2139","ESCUELA MUNICIPAL VIRGINIA BRAVO","6101","RANCAGUA","11","11","22"
"2140","ESCUELA MUNICIPAL AUGUSTO D HALMAR","6101","RANCAGUA","21","22","43"
"2143","ESCUELA MUNICIPAL HERMANOS CARRERA","6101","RANCAGUA","17","15","32"
"2206","ESCUELA SIXTO MENDEZ PARADA","6106","GRANEROS","24","27","51"
"2207","ESCUELA HERNAN OLGUIN MAYBE","6106","GRANEROS","33","44","77"
"2209","COLEGIO ANTONIO TRDAN ARKO","6106","GRANEROS","18","19","37"
"2210","ESCUELA MUNICIPAL VILLA LA COMPANIA","6106","GRANEROS","14","25","39"
"2212","ESCUELA MUNICIPAL DE TUNICHE","6106","GRANEROS","3","6","9"
"2223","COLEGIO ANDRES BELLO","6110","MOSTAZAL","25","31","56"
"2224","LICEO ELVIRA SANCHEZ DE GARCES","6110","MOSTAZAL","16","13","29"
"2226","ESC. HIJOS DEL SOL","6110","MOSTAZAL","8","13","21"
"2227","ESC. SAN FRANCISCO DE ASIS","6110","MOSTAZAL","7","4","11"
"2228","ESCUELA EL RINCON","6110","MOSTAZAL","12","11","23"
"2231","COLEGIO DEL CAMINO REAL","6110","MOSTAZAL","4","6","10"
"2234","COLEGIO JESUS ANDINO","6102","CODEGUA","36","28","64"
"2240","COLEGIO MUNICIPAL CRISTO DEL PARQUE","6102","CODEGUA","2","5","7"
"2247","COLEGIO GABRIELA MISTRAL","6108","MACHALI","25","35","60"
"2249","COLEGIO LOS LLANOS","6108","MACHALI","16","21","37"
"2250","COL. STA. TERESA DE LOS ANDES","6108","MACHALI","8","14","22"
"2251","COLEGIO BELLAVISTA","6108","MACHALI","7","13","20"
"2262","COL.MARIA VILLALOBOS ARTEAGA","6111","OLIVAR","20","25","45"
"2263","ESCUELA MUNICIPAL DE GULTRO","6111","OLIVAR","15","34","49"
"2264","ESCUELA NUESTRA SRA. DE LA MERCED","6111","OLIVAR","15","7","22"
"2265","ESCUELA BERTA SAAVEDRA SEGURA","6116","REQUINOA","19","23","42"
"2266","ESCUELA BASICA CAMPO LINDO","6116","REQUINOA","6","7","13"
"2267","ESC. REPUBLICA DE FRANCIA","6116","REQUINOA","11","19","30"
"2268","ESCUELA MUNICIPAL SANTA AMALIA","6116","REQUINOA","5","8","13"
"2275","ESCUELA DAVID DEL CURTO","6116","REQUINOA","9","21","30"
"2279","ESCUELA CANADA","6116","REQUINOA","17","20","37"
"2282","COLEGIO MUNICIPAL LO DE LOBO","6115","RENGO","6","6","12"
"2284","ESCUELA LA PAZ","6115","RENGO","31","30","61"
"2285","COLEGIO MANUEL FRANCISCO CORREA","6115","RENGO","9","14","23"
"2286","COLEGIO MUNICIPAL LUIS GALDAMES","6115","RENGO","37","38","75"
"2288","ESCUELA CARLOS CONDELL DE LA HAZA","6115","RENGO","6","10","16"
"2289","ESCUELA REPUBLICA DE ALEMANIA","6115","RENGO","25","25","50"
"2292","ESCUELA VICENTE HUIDOBRO","6115","RENGO","9","16","25"
"2294","COLEGIO MUNICIPAL LA ESMERALDA","6115","RENGO","10","13","23"
"2296","COLEGIO MUNICIPAL LO CARTAGENA","6115","RENGO","4","1","5"
"2297","ESCUELA GUSTAVO BISQUERTT S.","6115","RENGO","4","1","5"
"2299","COLEGIO MUNICIPAL EL CERRILLO","6115","RENGO","4","12","16"
"2300","ESCUELA LA ISLA EMMA ESCOBAR DE LAGOS","6115","RENGO","13","15","28"
"2301","COLEGIO MUNICIPAL DE APALTA","6115","RENGO","14","13","27"
"2307","ESCUELA MARTA AVARIA SALVATIERRA","6115","RENGO","2","5","7"
"2310","ESC.ALCIDES REYES FRIAS","6109","MALLOA","14","26","40"
"2311","ESCUELA PELEQUEN","6109","MALLOA","17","22","39"
"2312","ESCUELA MUNICIPAL DE PANQUEHUE","6109","MALLOA","3","9","12"
"2313","ESCUELA MUNICIPAL DE LIMAHUE","6109","MALLOA","6","10","16"
"2314","ESCUELA MUNICIPAL DE CORCOLEN","6109","MALLOA","5","5","10"
"2319","LICEO REPUBLICA DE ITALIA","6114","QUINTA DE TILCOCO","17","25","42"
"2320","VIOLETA FUENTES CARVAJAL","6114","QUINTA DE TILCOCO","5","9","14"
"2321","ESCUELA AMPARO RAYO HORTA","6114","QUINTA DE TILCOCO","7","6","13"
"2324","ESCUELA JAIME FELDMAN MILLER","6114","QUINTA DE TILCOCO","8","17","25"
"2325","COLEGIO RAÚL RAMÍREZ MAYOL","6114","QUINTA DE TILCOCO","10","11","21"
"2329","LICEO IGNACIO CARRERA PINTO","6117","SAN VICENTE","24","27","51"
"2330","ESC.CARMEN GALLEGOS DE ROBLE","6117","SAN VICENTE","51","43","94"
"2331","CENTRO EDUC. REQUEGUA","6117","SAN VICENTE","1","5","6"
"2333","ESC.GUIDO ASSIS GONZALEZ","6117","SAN VICENTE","3","8","11"
"2334","ESCUELA MUNICIPAL RASTROJOS","6117","SAN VICENTE","11","15","26"
"2335","ESC. ENRIQUE YANEZ GONZALEZ","6117","SAN VICENTE","3","5","8"
"2336","ESCUELA EL LIBERTADOR","6117","SAN VICENTE","8","11","19"
"2338","ESC.JUAN BARROS ROLDAN","6117","SAN VICENTE","4","11","15"
"2339","ESCUELA MUNICIPAL ZUNIGA","6117","SAN VICENTE","21","22","43"
"2347","ESC.PARROCO M.BUSTAMANTE","6117","SAN VICENTE","5","8","13"
"2348","ESCUELA MUNICIPAL VINA TAGUA TAGUA","6117","SAN VICENTE","4","8","12"
"2359","ESCUELA LARMAHUE","6113","PICHIDEGUA","11","10","21"
"2360","CENTRO EDUCATIVO SIGLO XXI","6113","PICHIDEGUA","9","17","26"
"2361","ESCUELA ENRIQUE SERRANO DE VIALE RIGO","6113","PICHIDEGUA","26","19","45"
"2362","ESCUELA AMELIA LYNCH DE LYON","6113","PICHIDEGUA","13","11","24"
"2363","ESCUELA MUNICIPAL DE SAN ROBERTO","6113","PICHIDEGUA","4","11","15"
"2364","ESCUELA REINO DE DINAMARCA","6113","PICHIDEGUA","12","6","18"
"2365","ESCUELA BASICA PATAGUAS CERRO","6113","PICHIDEGUA","15","14","29"
"2379","ESCUELA BASICA ANTONIO DE ZUNIGA","6112","PEUMO","21","19","40"
"2380","ESCUELA MUNICIPAL ALCALDE G. BURMESTER","6112","PEUMO","7","13","20"
"2381","ESCUELA JUAN VALDES ORTUZAR","6112","PEUMO","8","8","16"
"2384","ESCUELA BASICA ROSARIO DE CODAO","6112","PEUMO","1","7","8"
"2387","ESCUELA MUNICIPAL OSVALDO RUIZ GARCIA","6104","COLTAUCO","20","15","35"
"2388","ESCUELA MUNIC.SBTE LUIS CRUZ MARTINEZ","6104","COLTAUCO","13","16","29"
"2389","COLEGIO NUESTRA SEÑORA DE LORETO","6104","COLTAUCO","26","12","38"
"2390","COLEGIO QUILLAYQUEN RINCONADA DE PARRAL","6104","COLTAUCO","11","7","18"
"2393","ESCUELA MUNICIPAL DE LO DE CUEVAS","6104","COLTAUCO","6","3","9"
"2395","ESCUELA MUNICIPAL DE VINA LA CRUZ","6104","COLTAUCO","11","13","24"
"2397","ESCUELA CAPITAN IGNACIO CARRERA PINTO","6104","COLTAUCO","16","15","31"
"2398","ESCUELA SUBTTE. ARTURO PEREZ CANTO","6104","COLTAUCO","6","8","14"
"2407","ESCUELA MUNICIPAL CHILLEHUE","6103","COINCO","11","6","17"
"2409","ESCUELA MUNICIPAL COPEQUEN","6103","COINCO","15","18","33"
"2412","ESCUELA LAURA MATUS MELENDEZ","6105","DOÑIHUE","39","41","80"
"2414","COLEGIO MUNICIPAL LA ISLA","6105","DOÑIHUE","12","18","30"
"2415","ESCUELA LO MIRANDA","6105","DOÑIHUE","18","16","34"
"2416","COLEGIO REPUBLICA DE CHILE","6105","DOÑIHUE","22","15","37"
"2420","ESCUELA PLAZUELA","6105","DOÑIHUE","9","8","17"
"2422","LICEO FRANCISCO ANTONIO ENCINA ARMANET","6107","LAS CABRAS","5","4","9"
"2423","ESCUELA BASICA ROMILIO ARELLANO TRONCOSO","6107","LAS CABRAS","19","27","46"
"2424","ESCUELA OSVALDO CORREA FUENZALIDA","6107","LAS CABRAS","7","2","9"
"2425","ESCUELA MUNICIPAL DE LOS AROMOS","6107","LAS CABRAS","8","11","19"
"2426","ESC. CONTRAMAESTRE CONSTANTINO MICALVI","6107","LAS CABRAS","8","10","18"
"2427","ESCUELA MUNICIPAL MAESTRO JORGE LOPEZ OSORIO","6107","LAS CABRAS","7","11","18"
"2428","ESCUELA REPUBLICA DE GRECIA","6107","LAS CABRAS","11","14","25"
"2429","COLEGIO INES DE SUAREZ","6107","LAS CABRAS","13","9","22"
"2432","ESCUELA MUNICIPAL VILMA ALIAGA CALDERON","6107","LAS CABRAS","12","16","28"
"2438","ESCUELA MUNICIPAL DE LOS QUILLAYES","6107","LAS CABRAS","2","2","4"
"2456","ESCUELA OLEGARIO LAZO BAEZA","6301","SAN FERNANDO","16","44","60"
"2457","ESCUELA BASICA ISABEL LA CATOLICA","6301","SAN FERNANDO","40","23","63"
"2458","ESCUELA JORGE MUNOZ SILVA","6301","SAN FERNANDO","9","17","26"
"2459","COLEGIO GIUSEPPE BERTOLUZZI DE FELIP","6301","SAN FERNANDO","7","7","14"
"2460","ESCUELA MARIA LUISA BOUCHON","6301","SAN FERNANDO","6","8","14"
"2461","ESCUELA VILLA CENTINELA","6301","SAN FERNANDO","30","36","66"
"2462","ESCUELA WASHINGTON OMAR VENEGAS","6301","SAN FERNANDO","13","22","35"
"2464","ESCUELA JOSE DE SAN MARTIN","6301","SAN FERNANDO","5","7","12"
"2465","ESCUELA CONCENTRAC. RURAL SERGIO VERDUGO HERRERA","6301","SAN FERNANDO","12","10","22"
"2467","ESCUELA BAS.ABEL BOUCHON FAURE","6301","SAN FERNANDO","13","15","28"
"2469","ESCUELA ABRAHAM LINCOLN DE AGUA BUENA","6301","SAN FERNANDO","5","4","9"
"2470","ESCUELA BAS.SAN JOSE DE LOS LINGUES","6301","SAN FERNANDO","1","7","8"
"2471","ESCUELA BERNARDO MORENO FREDES","6301","SAN FERNANDO","5","11","16"
"2472","ESCUELA BASICA ANTONIO LARA MEDINA","6301","SAN FERNANDO","4","8","12"
"2476","ESCUELA BASICA GASPAR MARIN","6301","SAN FERNANDO","3","4","7"
"2487","ESCUELA BAS.FERNANDO ARENAS  ALMARZA","6303","CHIMBARONGO","17","21","38"
"2488","ESCUELA MUNICIPAL","6303","CHIMBARONGO","17","15","32"
"2489","ESCUELA BAS. VILLA CONVENTO VIEJO","6303","CHIMBARONGO","9","16","25"
"2490","ESCUELA MUNICIPAL","6303","CHIMBARONGO","5","7","12"
"2491","ESCUELA MUNICIPAL","6303","CHIMBARONGO","5","5","10"
"2492","ESCUELA MUNICIPAL","6303","CHIMBARONGO","2","6","8"
"2493","ESCUELA BAS. JOSE MIGUEL CARRERA VERDUGO","6303","CHIMBARONGO","12","9","21"
"2494","ESCUELA MUNICIPAL","6303","CHIMBARONGO","8","9","17"
"2495","ESCUELA MUNICIPAL","6303","CHIMBARONGO","6","6","12"
"2496","ESCUELA MUNICIPAL","6303","CHIMBARONGO","3","1","4"
"2498","ESCUELA MUNICIPAL","6303","CHIMBARONGO","12","6","18"
"2500","ESCUELA MUNICIPAL","6303","CHIMBARONGO","1","0","1"
"2505","ESCUELA MUNICIPAL","6303","CHIMBARONGO","6","2","8"
"2506","ESCUELA MUNICIPAL","6303","CHIMBARONGO","0","2","2"
"2507","ESCUELA MUNICIPAL","6303","CHIMBARONGO","1","6","7"
"2508","ESCUELA MUNICIPAL","6303","CHIMBARONGO","6","12","18"
"2513","ESCUELA MUNICIPAL","6303","CHIMBARONGO","2","4","6"
"2518","LICEO SAN FRANCISCO","6308","PLACILLA","17","14","31"
"2519","ESCUELA BASICA RAUL CACERES PACHECO","6308","PLACILLA","6","8","14"
"2520","ESCUELA MUNICIPAL LA DEHESA","6308","PLACILLA","1","6","7"
"2521","ESCUELA MUNICIPAL LA TUNA","6308","PLACILLA","4","12","16"
"2523","ESCUELA EL AMANECER","6308","PLACILLA","7","7","14"
"2524","ESCUELA DANY GERMAN GONZALEZ SOTO","6308","PLACILLA","5","8","13"
"2525","COLEGIO BASICO CONSOLIDADO","6305","NANCAGUA","23","23","46"
"2526","ESCUELA BAS. IGNACIO CARRERA PINTO","6305","NANCAGUA","3","7","10"
"2527","ESCUELA BÁSICA PUQUILLAY","6305","NANCAGUA","8","7","15"
"2528","ESCUELA BAS. ADRIANA LYON VIAL","6305","NANCAGUA","13","15","28"
"2532","COLEGIO LIBERTADOR O´HIGGINS DE CHEPICA","6302","CHEPICA","36","37","73"
"2537","ESCUELA LUIS ATHAS","6302","CHEPICA","3","5","8"
"2538","ESCUELA LINDORFO MONTERO FUENZALIDA","6302","CHEPICA","4","9","13"
"2539","ESCUELA LUIS ARTURO ZUNIGA FUENTES","6302","CHEPICA","7","7","14"
"2542","ESCUELA LUZ MARIA CRESPO URETA DE KERESTEGIAN","6302","CHEPICA","6","17","23"
"2553","ESCUELA MUNICIPAL DE SANTA CRUZ","6310","SANTA CRUZ","50","36","86"
"2555","ESCUELA MARIA  ARAYA VALDES","6310","SANTA CRUZ","4","11","15"
"2556","ESCUELA MUNICIPAL DE PANIAHUE","6310","SANTA CRUZ","9","9","18"
"2557","ESCUELA GRANJA ADEODATO GARCIA VALENZUELA","6310","SANTA CRUZ","2","4","6"
"2558","ESCUELA LA FINCA","6310","SANTA CRUZ","0","3","3"
"2559","ESCUELA MUNICIPAL DE BARREALES","6310","SANTA CRUZ","14","16","30"
"2560","ESC. MUNICIPAL LA LAJUELA","6310","SANTA CRUZ","3","4","7"
"2561","ESCUELA MUNICIPAL DE QUINAHUE","6310","SANTA CRUZ","2","6","8"
"2562","ESCUELA MUNICIPAL DE ISLA DE YAQUIL","6310","SANTA CRUZ","11","12","23"
"2563","ESCUELA MUNICIPAL DE LA PATAGUA","6310","SANTA CRUZ","6","2","8"
"2565","ESCUELA MUNICIPAL DE MILLAHUE DE APALTA","6310","SANTA CRUZ","7","10","17"
"2566","ESCUELA MUNICIPAL DE CUNACO","6305","NANCAGUA","14","10","24"
"2570","ESCUELA MUNICIPAL DE LOS MAITENES","6310","SANTA CRUZ","5","5","10"
"2576","ESCUELA MUNICIPAL DE GUINDO ALTO","6310","SANTA CRUZ","3","6","9"
"2577","ESCUELA ANGEL ARRIGORRIAGA","6310","SANTA CRUZ","6","3","9"
"2584","ESCUELA OCTAVIO MUJICA VALENZUELA","6304","LOLOL","15","12","27"
"2599","ESCUELA MUNICIPAL DE PUMANQUE","6309","PUMANQUE","4","6","10"
"2601","ESCUELA MUNICIPAL DE NILAHUE CORNEJO","6309","PUMANQUE","4","4","8"
"2611","ESCUELA MUNICIPAL DE PALMILLA","6306","PALMILLA","17","26","43"
"2612","LICEO SAN JOSE DEL CARMEN","6306","PALMILLA","19","15","34"
"2613","ESCUELA MUNICIPAL SANTA MATILDE","6306","PALMILLA","4","6","10"
"2615","ESCUELA JORGE ERRAZURIZ ECHEÑIQUE","6306","PALMILLA","8","16","24"
"2625","LICEO BICENTENARIO VICTOR JARA MARTINEZ","6307","PERALILLO","32","43","75"
"2626","COLEGIO MANUEL RODRIGUEZ ERDOIZA","6307","PERALILLO","18","27","45"
"2627","ESCUELA GUSTAVO RIVERA BUSTOS","6307","PERALILLO","4","1","5"
"2636","ESCUELA PUEBLO DE VIUDAS","6201","PICHILEMU","7","10","17"
"2637","ESCUELA MUNICIPAL VILLA SAN PEDRO","6206","PAREDONES","1","2","3"
"2650","ESCUELA CAHUIL","6201","PICHILEMU","2","4","6"
"2654","COLEGIO LIBERTADORES","6201","PICHILEMU","15","18","33"
"2657","LICEO MUNICIPAL PABLO NERUDA","6205","NAVIDAD","13","11","24"
"2660","ESCUELA FRANCISCO CHAVEZ CIFUENTES","6205","NAVIDAD","6","13","19"
"2664","ESCUELA BASICA CONFEDERACION HELVETICA","6205","NAVIDAD","11","12","23"
"2682","ESCUELA MUNICIPAL QUELENTARO","6203","LITUECHE","8","11","19"
"2686","ESCUELA MUNICIPAL PULIN","6203","LITUECHE","4","2","6"
"2694","ESCUELA PROF. MONICA SILVA GOMEZ","6202","LA ESTRELLA","14","14","28"
"2701","LICEO MUNICIPAL INSTITUTO CARDENAL CARO","6204","MARCHIHUE","0","5","5"
"2707","ESCUELA MUNICIPAL NOBELES DE CHILE","6204","MARCHIHUE","14","10","24"
"2708","ESCUELA MUNICIPAL PAILIMO","6204","MARCHIHUE","5","4","9"
"2714","ESCUELA UNION DE MUJERES AMERICANAS","6206","PAREDONES","7","9","16"
"2715","ESC.BASICA MERCEDES URZUA DIAZ","6206","PAREDONES","15","23","38"
"2716","ESCUELA MUNICIPAL SAN PEDRO DE ALCANTARA","6206","PAREDONES","2","1","3"
"2717","ESCUELA MUNICIPAL ALBERTINA VALENZUELA","6206","PAREDONES","6","3","9"
"2734","COLEGIO ALESSANDRI","7301","CURICO","12","33","45"
"2735","ESCUELA PRESIDENTE J.M.BALMACEDA","7301","CURICO","8","15","23"
"2736","ESCUELA PALESTINA","7301","CURICO","62","47","109"
"2737","COLEGIO POLIVALENTE JAPÓN","7301","CURICO","5","7","12"
"2738","ESCUELA REPUBLICA DE BRASIL","7301","CURICO","40","0","40"
"2740","ESCUELA GRECIA","7301","CURICO","18","14","32"
"2741","ESCUELA ERNESTO CASTRO ARELLANO","7301","CURICO","0","24","24"
"2742","ESC.REPUBLICA ORIENTAL DEL URUGUAY","7301","CURICO","24","30","54"
"2744","ESCUELA ESPANA","7301","CURICO","42","61","103"
"2745","ESCUELA CATALUNA","7301","CURICO","23","22","45"
"2747","ESCUELA SAN ANTONIO","7301","CURICO","3","9","12"
"2748","ESCUELA REPUBLICA ARGENTINA","7301","CURICO","22","22","44"
"2749","ESCUELA AGUAS NEGRAS","7301","CURICO","9","11","20"
"2750","ESCUELA MARIA INES RODRIGUEZ","7301","CURICO","3","6","9"
"2751","CENTRO INTEGRADO DE EDUCACION DE ADULTOS DE CURICO","7301","CURICO","12","7","19"
"2753","ESCUELA REPUBLICA ESTADOS UNIDOS","7301","CURICO","23","31","54"
"2754","ESCUELA INTERNADO POTRERO GRANDE","7301","CURICO","2","7","9"
"2755","ESCUELA MARIA OLGA FIGUEROA LEYTON","7301","CURICO","13","16","29"
"2756","ESCUELA DIEGO PORTALES P.","7301","CURICO","13","17","30"
"2758","ESCUELA OSVALDO CORREA FUENZALIDA","7301","CURICO","7","5","12"
"2761","ESCUELA LA OBRA","7301","CURICO","6","3","9"
"2762","ESCUELA EL PORVENIR","7301","CURICO","4","1","5"
"2763","ESCUELA REPUBLICA DE ITALIA","7301","CURICO","5","5","10"
"2764","ESCUELA ISLA DE MARCHANT","7301","CURICO","6","6","12"
"2776","ESCUELA EL MAITEN","7301","CURICO","5","6","11"
"2780","ESCUELA HOLANDA","7301","CURICO","8","5","13"
"2795","ESCUELA TENO","7308","TENO","30","29","59"
"2796","ESCUELA COMALLE","7308","TENO","17","13","30"
"2800","ESCUELA MORZA","7308","TENO","4","6","10"
"2801","ESCUELA MONTERILLA","7308","TENO","7","11","18"
"2802","ESCUELA SUSANA MONTES VELASCO","7308","TENO","15","17","32"
"2803","ESCUELA LAS ARBOLEDAS","7308","TENO","18","20","38"
"2804","ESC. MANUEL RODRIGUEZ ERDOIZA","7308","TENO","1","5","6"
"2805","ESCUELA ALBORADA VENTANA DEL BAJO","7308","TENO","5","5","10"
"2806","ESCUELA HUEMUL","7308","TENO","3","2","5"
"2814","ESCUELA SAN RAFAEL","7308","TENO","4","4","8"
"2817","ESCUELA SAN CRISTOBAL","7308","TENO","8","20","28"
"2820","ESCUELA LOS ALISOS","7308","TENO","3","2","5"
"2822","ESCUELA ARTURO ALESSANDRI PALMA","7306","ROMERAL","5","9","14"
"2823","ESCUELA RAMON FREIRE","7306","ROMERAL","18","22","40"
"2825","ESCUELA AMERICA LATINA","7306","ROMERAL","7","7","14"
"2826","ESCUELA TRES ESQUINAS","7306","ROMERAL","5","8","13"
"2827","ESCUELA GUAICO CENTRO","7306","ROMERAL","7","6","13"
"2829","ESCUELA BASICA LUIS ESCOBAR LARA","7306","ROMERAL","3","1","4"
"2830","ESCUELA CARLOS LAZCANO ALFONSO","7306","ROMERAL","4","8","12"
"2831","ESCUELA GERARDO RODRIGUEZ ORTUZAR","7306","ROMERAL","0","3","3"
"2837","ESCUELA SUPERIOR DE HOMBRES","7304","MOLINA","0","13","13"
"2839","ESCUELA PRESIDENTE EDUARDO FREI MONTALVA","7304","MOLINA","14","27","41"
"2840","ESCUELA SUPERIOR DE NINAS DE MOLINA","7304","MOLINA","19","0","19"
"2842","LUIS MALDONADO BOGGIANO","7304","MOLINA","6","6","12"
"2843","ESCUELA EL PROGRESO","7304","MOLINA","6","11","17"
"2844","ESC.INTERN.LAS PALMAS TRES ESQUINAS","7304","MOLINA","2","5","7"
"2845","ESCUELA SAN PEDRO DE MOLINA","7304","MOLINA","13","13","26"
"2847","ESCUELA CASA BLANCA","7304","MOLINA","22","22","44"
"2848","ESCUELA QUECHEREGUAS DE PICHINGAL","7304","MOLINA","8","9","17"
"2859","ESCUELA BAJO LOS ROMEROS","7304","MOLINA","9","17","26"
"2866","ESCUELA VILLA PRAT","7307","SAGRADA FAMILIA","18","16","34"
"2867","ESC.DE EDUC.GRAL. BASICA MONSENOR ENRIQUE COR","7307","SAGRADA FAMILIA","31","24","55"
"2868","ESCUELA SANTA ROSA","7307","SAGRADA FAMILIA","5","16","21"
"2870","ESCUELA LA ISLA","7307","SAGRADA FAMILIA","14","10","24"
"2871","ESCUELA LO VALDIVIA","7307","SAGRADA FAMILIA","18","14","32"
"2873","ESCUELA JOSE CANEPA VACCAREZZA","7307","SAGRADA FAMILIA","11","8","19"
"2875","ESCUELA SANTA EMILIA","7307","SAGRADA FAMILIA","10","5","15"
"2876","ESCUELA EUGENIO TAGLE VALDES","7307","SAGRADA FAMILIA","4","5","9"
"2883","ESCUELA LA HUERTA DE MATAQUITO","7302","HUALAÑE","11","4","15"
"2884","ESCUELA CARLOS CORREA NUNEZ","7302","HUALAÑE","5","7","12"
"2892","ESCUELA DE BARBA RUBIA","7302","HUALAÑE","3","4","7"
"2894","ESCUELA AMELIA VIAL DE CONCHA","7302","HUALAÑE","17","11","28"
"2896","LICEO AUGUSTO SANTELICES VALENZUELA","7303","LICANTEN","32","23","55"
"2903","COLEGIO DR. MANUEL AVILES INOSTROZA","7303","LICANTEN","11","14","25"
"2908","ESCUELA ALEJANDRO ROJAS SIERRA","7303","LICANTEN","1","3","4"
"2909","LICEO NUEVO HORIZONTE","7309","VICHUQUEN","3","6","9"
"2910","ESCUELA ENTRE AGUAS DE LLICO","7309","VICHUQUEN","18","9","27"
"2911","ESCUELA LAGO VICHUQUEN","7309","VICHUQUEN","3","5","8"
"2914","ESCUELA EMA CORNEJO DE CARDOEN","7309","VICHUQUEN","2","1","3"
"2917","ESCUELA RAUCO","7305","RAUCO","17","23","40"
"2918","ESCUELA LOS ALMENDROS","7305","RAUCO","3","12","15"
"2920","ESCUELA LUIS LEYTON RUBIO","7305","RAUCO","9","5","14"
"2927","ESCUELA EL PLUMERO","7305","RAUCO","9","8","17"
"2930","LICEO DE CULTURA Y DIFUSION ARTISTICA","7101","TALCA","40","21","61"
"2935","LICEO MARTA DONOSO ESPEJO","7101","TALCA","30","15","45"
"2940","LICEO CARLOS CONDELL","7101","TALCA","1","18","19"
"2941","ESCUELA SARGENTO 2DO DANIEL REBOLLEDO","7101","TALCA","10","6","16"
"2942","ESCUELA JUAN LUIS SANFUENTES","7101","TALCA","68","79","147"
"2943","LICEO HECTOR PEREZ BIOTT","7101","TALCA","0","3","3"
"2944","ESCUELA JOSE M. BALMACEDA Y FERNANDEZ","7101","TALCA","78","0","78"
"2945","ESCUELA PROSPERIDAD","7101","TALCA","25","40","65"
"2946","ESCUELA CARLOS SPANO","7101","TALCA","23","20","43"
"2947","ESCUELA LAS ARAUCARIAS","7101","TALCA","5","8","13"
"2948","ESCUELA CARLOS SALINAS LAGOS","7101","TALCA","56","84","140"
"2949","ESCUELA BASICA","7101","TALCA","60","51","111"
"2950","ESCUELA EL EDEN","7101","TALCA","17","17","34"
"2951","ESCUELA LA FLORIDA","7101","TALCA","7","11","18"
"2952","ESCUELA VILLA LA PAZ","7101","TALCA","6","16","22"
"2955","ESCUELA BRILLA EL SOL","7101","TALCA","11","5","16"
"2956","ESCUELA AURORA DE CHILE","7101","TALCA","13","33","46"
"2957","ESCUELA UNO SAN AGUSTIN","7101","TALCA","24","37","61"
"2958","ESCUELA JOSE ABELARDO NUNEZ","7101","TALCA","22","38","60"
"2959","LORENZO VAROLI GHERARDI","7101","TALCA","18","21","39"
"2964","ESCUELA LAS AMERICAS","7101","TALCA","44","40","84"
"2965","ESCUELA COOPERATIVA LIRCAY MANUEL YAÑEZ OLAVE","7101","TALCA","31","26","57"
"2966","ESCUELA COSTANERA","7101","TALCA","6","13","19"
"2968","ESCUELA ANTUPEHUEN","7101","TALCA","6","10","16"
"2972","ESCUELA ESPERANZA","7101","TALCA","22","19","41"
"2973","LICEO ABATE MOLINA","7101","TALCA","71","64","135"
"2975","ESCUELA HUILQUILEMU","7101","TALCA","4","8","12"
"2977","ESCUELA VINA PURISIMA","7101","TALCA","9","13","22"
"2978","ESCUELA SAN MIGUEL","7101","TALCA","11","13","24"
"2979","ESCUELA EL SAUCE","7101","TALCA","21","13","34"
"2980","ESCUELA SANTA MARTA","7101","TALCA","3","7","10"
"2981","ESCUELA PANGUILEMO","7101","TALCA","11","13","24"
"2983","ESCUELA BASICA PUERTAS NEGRAS","7101","TALCA","3","3","6"
"2986","ESCUELA EL ORIENTE","7101","TALCA","5","4","9"
"3016","LICEO DE PELARCO","7106","PELARCO","17","12","29"
"3017","ESCUELA SAN RAFAEL","7110","SAN RAFAEL","27","37","64"
"3019","ESCUELA HERNAN CIUDAD INOSTROZA","7106","PELARCO","18","19","37"
"3020","ESCUELA ALTO PANGUE","7110","SAN RAFAEL","7","10","17"
"3022","ESCUELA PABLO CORREA MONTT","7106","PELARCO","4","6","10"
"3023","ESCUELA EL MANZANO","7106","PELARCO","2","5","7"
"3025","ESCUELA PANGUE ARRIBA","7110","SAN RAFAEL","6","11","17"
"3028","ESCUELA EL MILAGRO","7110","SAN RAFAEL","5","6","11"
"3033","LICEO AGROINDUSTRIAL RIO CLARO","7108","RIO CLARO","30","28","58"
"3034","ESCUELA BASICA JUAN LUIS SANFUENTES ANDONAEGUI","7108","RIO CLARO","9","11","20"
"3037","ESCUELA PORVENIR","7108","RIO CLARO","12","14","26"
"3038","ESCUELA LA CHISPA","7108","RIO CLARO","4","5","9"
"3039","ESCUELA ODESSA","7108","RIO CLARO","10","16","26"
"3045","ESCUELA SANTA HERMINIA","7108","RIO CLARO","5","5","10"
"3056","ESCUELA SAN CLEMENTE","7109","SAN CLEMENTE","21","36","57"
"3057","ESCUELA ARTURO PRAT CHACON","7109","SAN CLEMENTE","6","16","22"
"3058","ESCUELA AURORA","7109","SAN CLEMENTE","8","17","25"
"3059","ESCUELA DEIDAMIA PAREDES BELLO","7109","SAN CLEMENTE","11","19","30"
"3060","ESCUELA RAMADILLAS","7109","SAN CLEMENTE","30","16","46"
"3061","ESCUELA PUNTA DE DIAMANTE","7109","SAN CLEMENTE","1","3","4"
"3062","ESCUELA PEUMO NEGRO","7109","SAN CLEMENTE","1","7","8"
"3063","ESCUELA CORRALONES","7109","SAN CLEMENTE","9","4","13"
"3065","ESCUELA ENRIQUE CORREA GUZMAN","7109","SAN CLEMENTE","9","4","13"
"3067","ESCUELA LEOPOLDO GUARDA GEYNTES","7109","SAN CLEMENTE","2","3","5"
"3068","ESCUELA BELLA UNION","7109","SAN CLEMENTE","2","3","5"
"3069","ESCUELA QUERI","7109","SAN CLEMENTE","2","14","16"
"3070","ESCUELA CHEQUEN DE LA PENA","7109","SAN CLEMENTE","11","15","26"
"3079","ESCUELA ELENA BURGOS MOREIRA","7109","SAN CLEMENTE","2","2","4"
"3081","ESCUELA BAJO PERQUIN","7109","SAN CLEMENTE","6","11","17"
"3084","ESCUELA LOS ROBLES DE VILCHES CENTRO","7109","SAN CLEMENTE","1","0","1"
"3085","ESCUELA PASO NEVADO","7109","SAN CLEMENTE","8","1","9"
"3086","ESCUELA LOS MONTES","7109","SAN CLEMENTE","4","6","10"
"3090","ESCUELA EL COLORADO","7109","SAN CLEMENTE","14","8","22"
"3093","ESCUELA CARRETONES","7109","SAN CLEMENTE","0","1","1"
"3096","ESCUELA LOS ALMENDROS","7109","SAN CLEMENTE","5","3","8"
"3104","ESCUELA LA PLACETA","7109","SAN CLEMENTE","0","1","1"
"3107","ESCUELA SANTA ELENA","7109","SAN CLEMENTE","2","5","7"
"3110","ESCUELA MAULE","7105","MAULE","34","27","61"
"3111","ESCUELA VILLA CULENAR","7101","TALCA","20","32","52"
"3112","ESCUELA CALLEJONES","7105","MAULE","10","11","21"
"3113","ESCUELA COLIN","7105","MAULE","12","17","29"
"3114","ESCUELA CHACARILLA","7105","MAULE","20","23","43"
"3115","ESCUELA RURAL DUAO","7105","MAULE","1","6","7"
"3117","ESCUELA RURAL NUMPAY","7105","MAULE","7","12","19"
"3118","ESCUELA QUINIPEUMO","7105","MAULE","4","11","15"
"3128","LICEO SAN IGNACIO","7104","EMPEDRADO","18","26","44"
"3130","ESCUELA PEDRO ANTONIO TEJOS TEJOS","7104","EMPEDRADO","6","9","15"
"3134","ESCUELA MARIA OLGA VEGA VEGA","7104","EMPEDRADO","4","3","7"
"3138","COMPLEJO EDUCACIONAL PENCAHUE","7107","PENCAHUE","23","20","43"
"3139","ESCUELA PADRE LUIS OLIVA NAVARRETE","7107","PENCAHUE","1","6","7"
"3140","ESCUELA CORINTO","7107","PENCAHUE","5","0","5"
"3143","ESCUELA SANTA LAURA DE LO FIGUEROA","7107","PENCAHUE","13","8","21"
"3166","ESCUELA ENRIQUE DONN MULLER","7102","CONSTITUCION","25","20","45"
"3168","ESCUELA SUPERIOR NUEVA BILBAO","7102","CONSTITUCION","12","19","31"
"3169","ESCUELA CERRO ALTO JOSE OPAZO DIAZ","7102","CONSTITUCION","59","69","128"
"3172","LICEO RURAL PUTU","7102","CONSTITUCION","15","17","32"
"3173","LICEO RURAL ENRIQUE MAC IVER","7102","CONSTITUCION","15","31","46"
"3174","ESCUELA LAS CORRIENTES","7102","CONSTITUCION","6","8","14"
"3185","ESCUELA COSTA BLANCA","7102","CONSTITUCION","15","11","26"
"3191","ESCUELA SANTA AURORA DE CARRIZAL","7102","CONSTITUCION","3","3","6"
"3206","ESCUELA FRAY PEDRO ARMENGOL VALENZUELA","7103","CUREPTO","4","2","6"
"3207","ESCUELA PEDRO ANTONIO GONZALEZ","7103","CUREPTO","29","29","58"
"3209","ESCUELA ELENA ARMIJO MORALES","7103","CUREPTO","6","11","17"
"3217","ESCUELA JUAN JESUS GONZALEZ AVENDAÑO","7103","CUREPTO","1","3","4"
"3238","ESCUELA MARINA ROJAS SANDOVAL","7103","CUREPTO","2","5","7"
"3247","LICEO VALENTIN LETELIER","7401","LINARES","57","39","96"
"3249","ESCUELA UNO ISABEL RIQUELME","7401","LINARES","30","15","45"
"3250","ESCUELA PRESIDENTE CARLOS IBANEZ DEL C.","7401","LINARES","16","27","43"
"3251","ESCUELA REPUBLICA DE FRANCIA","7401","LINARES","37","33","70"
"3253","JUAN MARTINEZ DE ROZAS","7401","LINARES","4","9","13"
"3255","ESCUELA SANTA BARBARA","7401","LINARES","6","18","24"
"3256","ESCUELA RAMON BELMAR SALDIAS","7401","LINARES","29","32","61"
"3257","ESCUELA ALEJANDRO GIDI","7401","LINARES","8","8","16"
"3258","ESCUELA BASICA ESPANA","7401","LINARES","24","29","53"
"3260","ESCUELA LOS LEONES","7401","LINARES","8","10","18"
"3261","PEDRO AGUIRRE CERDA","7401","LINARES","10","11","21"
"3263","ESCUELA MAITENES","7401","LINARES","10","6","16"
"3264","ESCUELA SAN VICTOR ALAMOS","7401","LINARES","9","5","14"
"3266","ESCUELA SAN ANTONIO","7401","LINARES","11","10","21"
"3267","ESCUELA GRACIELA LETELIER","7401","LINARES","23","29","52"
"3268","ESCUELA SALOMON SALMAN DABUD","7401","LINARES","18","17","35"
"3269","ESCUELA LAS HORNILLAS","7401","LINARES","8","6","14"
"3270","JANUARIO ESPINOSA","7401","LINARES","3","2","5"
"3273","ESCUELA MATIAS COUSINO","7401","LINARES","10","2","12"
"3285","ESCUELA LLANKANAO MANUEL FRANCISCO MEZA SECO","7401","LINARES","12","12","24"
"3313","LICEO JUAN DE DIOS PUGA","7408","YERBAS BUENAS","18","15","33"
"3314","ESCUELA MAITENCILLO","7408","YERBAS BUENAS","5","12","17"
"3315","ESCUELA SILVANO FERNANDEZ","7408","YERBAS BUENAS","14","13","27"
"3316","ESCUELA SANTA ANA DE QUERI","7408","YERBAS BUENAS","5","5","10"
"3317","LICEO JUAN GOMEZ MILLAS","7408","YERBAS BUENAS","4","11","15"
"3318","ESCUELA JORGE SALGADO PICA","7408","YERBAS BUENAS","7","5","12"
"3319","ESCUELA ALFREDO NOGUERA PRIETO","7407","VILLA ALEGRE","20","11","31"
"3321","ESCUELA SANTA ELENA","7408","YERBAS BUENAS","2","3","5"
"3323","ESCUELA LUIS AMBROSIO CONCHA","7408","YERBAS BUENAS","11","15","26"
"3329","ESCUELA MAULE SUR","7402","COLBUN","10","19","29"
"3330","ESCUELA LA FLORESTA","7402","COLBUN","8","13","21"
"3332","ESCUELA ANDRES BELLO","7402","COLBUN","7","10","17"
"3333","ESCUELA CARLOS DEL CAMPO RIVERA","7402","COLBUN","10","8","18"
"3334","ESCUELA MONSENOR MANUEL LARRAIN E.","7402","COLBUN","17","10","27"
"3335","ESCUELA PANIMAVIDA","7402","COLBUN","12","25","37"
"3345","ESCUELA  LOMAS DE PUTAGAN","7402","COLBUN","1","2","3"
"3349","ESCUELA JUAN DE LA CRUZ DOMINGUEZ G.","7403","LONGAVI","25","32","57"
"3352","ESCUELA ANSELMO DEL CARMEN TAPIA LOYOLA","7403","LONGAVI","5","7","12"
"3353","ESCUELA ROBERTO OPAZO GALVEZ","7403","LONGAVI","7","6","13"
"3354","ESCUELA ONOFRE VASQUEZ NORAMBUENA","7403","LONGAVI","4","10","14"
"3355","ESCUELA GABRIELA MISTRAL","7403","LONGAVI","10","9","19"
"3356","ESCUELA CARDENAL JOSE MARIA CARO","7403","LONGAVI","12","16","28"
"3358","ESCUELA JOSE MIGUEL CARRERA","7403","LONGAVI","5","8","13"
"3359","LICEO LAURA URRUTIA BENAVENTE","7403","LONGAVI","6","5","11"
"3361","ESCUELA FRANCISCO URRUTIA URRUTIA","7403","LONGAVI","14","7","21"
"3362","ESCUELA GABRIEL BENAVENTE BENAVENTE","7403","LONGAVI","15","6","21"
"3364","ESCUELA LUIS PEREIRA INIGUEZ","7403","LONGAVI","2","0","2"
"3365","ESCUELA MARIA AMBROSIA TAPIA MENDEZ","7403","LONGAVI","6","2","8"
"3368","ESCUELA JUAN SEGUNDO MUNOZ BRIONES","7403","LONGAVI","1","5","6"
"3371","ESCUELA PAULA JARAQUEMADA","7403","LONGAVI","3","3","6"
"3376","ESCUELA MARCELA PAZ","7403","LONGAVI","4","5","9"
"3381","ESCUELA ANGEL CRUCHAGA SANTA MARIA","7403","LONGAVI","3","7","10"
"3382","ESCUELA PEDRO ALESSANDRI VARGAS","7403","LONGAVI","7","7","14"
"3387","LICEO FEDERICO HEISE MARTI","7404","PARRAL","2","8","10"
"3389","ESCUELA SANTIAGO URRUTIA BENAVENTE","7404","PARRAL","12","14","26"
"3390","ESCUELA LUIS ARMANDO GOMEZ MUNOZ","7404","PARRAL","16","12","28"
"3393","ESCUELA ARRAU MENDEZ","7404","PARRAL","18","20","38"
"3395","ESCUELA NIDER ORREGO QUEVEDO","7404","PARRAL","19","24","43"
"3396","ESCUELA JUANITA ZUNIGA FUENTES","7404","PARRAL","2","4","6"
"3398","ESCUELA JOSE MATTA CALLEJON","7404","PARRAL","17","16","33"
"3400","COLEGIO ALBERTO MOLINA CASTILLO","7404","PARRAL","3","5","8"
"3401","ESCUELA EL LIBERTADOR","7404","PARRAL","4","7","11"
"3402","ESCUELA FRANCISCO PEREZ LAVIN","7404","PARRAL","4","7","11"
"3404","ESCUELA IGNACIO URRUTIA DE LA SOTTA","7404","PARRAL","6","9","15"
"3405","ESCUELA ARMANDO GUZMAN MORALES","7404","PARRAL","3","9","12"
"3408","ESCUELA FRANCISCO MAUREIRA","7404","PARRAL","5","6","11"
"3434","LICEO GUILLERMO MARIN LARRAIN","7405","RETIRO","14","11","25"
"3435","ESCUELA MANUEL MONTT","7405","RETIRO","23","29","52"
"3436","ESCUELA COPIHUE","7405","RETIRO","9","15","24"
"3437","ESCUELA RAMON BARROS LUCO","7405","RETIRO","5","4","9"
"3440","ESCUELA GERTRUDIS ALARCON ARCE","7405","RETIRO","4","4","8"
"3442","COLEGIO AJIAL","7405","RETIRO","16","8","24"
"3443","COLEGIO ROBINSON CABRERA BELTRAN","7405","RETIRO","14","14","28"
"3445","ESCUELA ROMERAL","7405","RETIRO","4","1","5"
"3448","ESCUELA SANTA ISABEL","7405","RETIRO","4","2","6"
"3449","ESCUELA SAN RAMON","7405","RETIRO","0","2","2"
"3454","ESCUELA LOS ROBLES","7405","RETIRO","1","4","5"
"3458","ESCUELA MARIA IGNACIA MENA MONROY","7405","RETIRO","4","0","4"
"3461","LICEO FRANCISCO ANTONIO ENCINA ARMANET","7407","VILLA ALEGRE","4","3","7"
"3462","ESCUELA TIMOTEO ARAYA ALEGRIA","7407","VILLA ALEGRE","17","27","44"
"3463","ESCUELA MALAQUIAS CONCHA ORTIZ","7407","VILLA ALEGRE","2","6","8"
"3464","ESCUELA HERNAN LOBOS ARIAS","7407","VILLA ALEGRE","14","12","26"
"3465","ESCUELA ALCALDE SERAFIN GUTIERREZ F.","7407","VILLA ALEGRE","3","2","5"
"3466","ESCUELA ALCALDE ORLANDO RODRIGUEZ DEL C.","7407","VILLA ALEGRE","6","6","12"
"3468","ESCUELA ASCENCIO ASTORQUIZA ZABALA","7407","VILLA ALEGRE","2","1","3"
"3470","ESCUELA TRINIDAD ALCAINO TAPIA","7407","VILLA ALEGRE","15","7","22"
"3471","ESCUELA PROFESOR RAMON LEIVA NARVAEZ","7407","VILLA ALEGRE","11","7","18"
"3475","ESCUELA JOSE PALMA FERNANDEZ","7407","VILLA ALEGRE","8","16","24"
"3480","ESCUELA JOSE MANUEL BALMACEDA","7406","SAN JAVIER","28","41","69"
"3481","ESCUELA MANUEL DE SALAS","7406","SAN JAVIER","14","26","40"
"3482","ESCUELA JUSTA NARVAEZ","7406","SAN JAVIER","2","13","15"
"3483","ESCUELA GERONIMO LAGOS LISBOA","7406","SAN JAVIER","24","31","55"
"3489","ESCUELA JORGE GONZALEZ BASTIAS","7406","SAN JAVIER","3","5","8"
"3490","ESCUELA JULIO MONTT SALAMANCA","7406","SAN JAVIER","11","14","25"
"3491","ESCUELA JUAN DE DIOS ALDEA","7406","SAN JAVIER","5","8","13"
"3492","ESCUELA BERNARDO OHIGGINS","7406","SAN JAVIER","12","12","24"
"3494","ESCUELA MANUEL RODRIGUEZ","7406","SAN JAVIER","8","10","18"
"3495","ESCUELA PEDRO LAGOS","7406","SAN JAVIER","11","12","23"
"3497","ESCUELA JOSE MIGUEL CARRERA","7406","SAN JAVIER","17","10","27"
"3517","ESCUELA CANDELARIA PEREZ","7406","SAN JAVIER","0","7","7"
"3520","ESCUELA MARIANO LATORRE","7406","SAN JAVIER","3","2","5"
"3538","LICEO ANTONIO VARAS","7201","CAUQUENES","36","45","81"
"3539","LICEO CLAUDINA URRUTIA DE LAVIN","7201","CAUQUENES","21","15","36"
"3541","ESCUELA ANIBAL PINTO","7201","CAUQUENES","33","32","65"
"3544","COLEGIO BLANCO ENCALADA","7201","CAUQUENES","20","10","30"
"3545","ESCUELA ARTISTICA BARRIO ESTACION","7201","CAUQUENES","17","23","40"
"3546","ESCUELA INDEPENDENCIA","7201","CAUQUENES","20","18","38"
"3548","ESCUELA ROSITA OHIGGINS","7201","CAUQUENES","6","9","15"
"3549","ESCUELA PORONGO","7201","CAUQUENES","16","19","35"
"3550","ESCUELA PURISIMA CONCEPCION DE POCILLAS","7201","CAUQUENES","2","1","3"
"3551","ESCUELA LOS CONQUISTADORES","7201","CAUQUENES","13","8","21"
"3552","ESCUELA ADOLFO QUIROZ HERNANDEZ","7201","CAUQUENES","8","4","12"
"3554","ESCUELA CLORINDO ALVEAR","7201","CAUQUENES","6","4","10"
"3555","ESCUELA OCTAVIO PALMA PEREZ","7201","CAUQUENES","3","5","8"
"3588","ESCUELA ESTER URRUTIA DE RUIZ","7201","CAUQUENES","1","2","3"
"3602","ESCUELA EL TROZO","7201","CAUQUENES","2","4","6"
"3604","ESCUELA CABRERIA","7201","CAUQUENES","3","2","5"
"3609","LICEO PELLUHUE","7203","PELLUHUE","22","34","56"
"3610","ESCUELA GLADYS CANALES PAREDES","7203","PELLUHUE","16","14","30"
"3611","ESCUELLA BLANCA BUSTOS CASTILLO","7203","PELLUHUE","10","5","15"
"3619","ESCUELA LOS HEROES","7202","CHANCO","12","19","31"
"3621","ESCUELA SAN AMBROSIO","7202","CHANCO","16","17","33"
"3622","ESCUELA PAHUIL","7202","CHANCO","12","9","21"
"3623","ESCUELA CARRERAS CORTAS","7202","CHANCO","3","2","5"
"3638","LICEO BICENTENARIO MARTA BRUNET CÁRAVES","8401","CHILLAN","12","6","18"
"3639","LICEO NARCISO TONDREAU","8401","CHILLAN","2","4","6"
"3645","LICEO VIDA NUEVA","8401","CHILLAN","16","13","29"
"3653","ESCUELA BASICA DIEGO BARROS ARANA","8401","CHILLAN","14","11","25"
"3654","ESCUELA BASICA LOS HEROES","8401","CHILLAN","26","40","66"
"3656","LICEO POLIVALENTE JUAN PACHECO ALTAMIRANO","8406","CHILLAN VIEJO","10","17","27"
"3657","LICEO LIBERTADOR BERNARDO O`HIGGINS RIQUELME","8401","CHILLAN","20","29","49"
"3658","ESCUELA REPUBLICA DE ISRAEL","8401","CHILLAN","5","10","15"
"3659","ESCUELA ARTURO MERINO BENITEZ","8401","CHILLAN","9","10","19"
"3660","ESCUELA GABRIELA MISTRAL","8401","CHILLAN","4","11","15"
"3662","ESCUELA REPUBLICA DE ITALIA","8401","CHILLAN","23","34","57"
"3663","ESCUELA REPUBLICA DE MEXICO","8401","CHILLAN","24","38","62"
"3664","ESCUELA BASICA EL TEJAR","8401","CHILLAN","8","11","19"
"3666","ESCUELA MARIA AMALIA SAAVEDRA MARTINEZ","8401","CHILLAN","8","5","13"
"3667","ESCUELA BASICA LA CASTILLA","8401","CHILLAN","8","10","18"
"3668","ESCUELA PALESTINA","8401","CHILLAN","8","11","19"
"3669","ESCUELA BÁSICA ROSITA O´HIGGINS RIQUELME","8401","CHILLAN","12","13","25"
"3670","ESCUELA BASICA REYES DE ESPANA","8401","CHILLAN","37","46","83"
"3671","ESCUELA BASICA JUAN MADRID AZOLA","8401","CHILLAN","13","16","29"
"3672","ESC. BASICA ARTURO MUTIZABAL SOTOMAYOR","8401","CHILLAN","3","5","8"
"3673","ESCUELA BASICA QUILAMAPU","8401","CHILLAN","8","9","17"
"3674","ESCUELA REPUBLICA DE PORTUGAL","8401","CHILLAN","3","2","5"
"3675","ESCUELA BASICA JOSE MARIA CARO RODRIGUEZ","8401","CHILLAN","8","13","21"
"3677","ESCUELA BASICA LAS CANOAS","8401","CHILLAN","8","12","20"
"3678","ESCUELA 27 DE ABRIL","8401","CHILLAN","5","0","5"
"3681","ESCUELA BASICA CAPILLA COX","8401","CHILLAN","5","8","13"
"3683","ESCUELA BASICA RUCAPEQUEN","8406","CHILLAN VIEJO","3","7","10"
"3685","ESCUELA BASICA QUINCHAMALI","8401","CHILLAN","16","9","25"
"3686","ESCUELA BASICA NEBUCO","8406","CHILLAN VIEJO","5","4","9"
"3691","ESCUELA PAUL HARRIS","8401","CHILLAN","3","1","4"
"3703","ESCUELA ANTONIO MACHADO","8401","CHILLAN","8","7","15"
"3704","ESCUELA BASICA COLLIGUAY","8401","CHILLAN","1","3","4"
"3709","ESCUELA BASICA LOS COLIGUES","8406","CHILLAN VIEJO","0","5","5"
"3740","ESCUELA GENERAL DOMINGO URRUTIA","8416","SAN CARLOS","8","14","22"
"3741","CENTRO EDUCACIÓN INTEGRAL ADULTOS CLAUDIO MATTE PÉREZ","8416","SAN CARLOS","3","0","3"
"3743","LICEO DIEGO PORTALES PALAZUELOS","8416","SAN CARLOS","17","25","42"
"3744","ESCUELA GENERAL JOSÉ MIGUEL CARRERA VERDUGO","8416","SAN CARLOS","12","14","26"
"3745","ESCUELA GENERAL SOFANOR PARRA HERMOSILLA","8416","SAN CARLOS","17","25","42"
"3749","ESCUELA JOAQUIN DEL PINO ROZAS Y NEGRETE","8416","SAN CARLOS","7","11","18"
"3754","ESCUELA BULI","8416","SAN CARLOS","2","1","3"
"3755","ESCUELA NINQUIHUE","8416","SAN CARLOS","12","6","18"
"3757","ESCUELA AGUA BUENA","8416","SAN CARLOS","1","0","1"
"3758","ESCUELA EL CARBON","8416","SAN CARLOS","5","6","11"
"3759","ESCUELA CACHAPOAL","8416","SAN CARLOS","7","9","16"
"3760","ESCUELA RIBERA DE NUBLE","8416","SAN CARLOS","8","9","17"
"3762","ESCUELA MONTE BLANCO","8416","SAN CARLOS","8","10","18"
"3768","ESCUELA LAS ARBOLEDAS","8416","SAN CARLOS","11","14","25"
"3776","ESCUELA QUILELTO","8416","SAN CARLOS","2","0","2"
"3781","ESCUELA MILLAUQUEN","8416","SAN CARLOS","3","1","4"
"3782","ESCUELA MANUEL ANTONIO CASTILLO VELASCO","8416","SAN CARLOS","8","7","15"
"3783","ESCUELAS LAS JUNTAS","8416","SAN CARLOS","1","1","2"
"3784","ESCUELA JUNQUILLO","8416","SAN CARLOS","3","2","5"
"3786","ESCUELA EL SAUCE","8416","SAN CARLOS","9","10","19"
"3798","ESCUELA SAN JORGE DE NIQUEN","8409","ÑIQUEN","5","15","20"
"3799","ESCUELA CHACAY","8409","ÑIQUEN","11","12","23"
"3800","LICEO TIUQUILEMU","8409","ÑIQUEN","6","6","12"
"3801","ESCUELA NIQUEN","8409","ÑIQUEN","9","4","13"
"3802","LICEO SAN GREGORIO","8409","ÑIQUEN","27","19","46"
"3804","ESCUELA ZEMITA","8409","ÑIQUEN","3","4","7"
"3814","ESCUELA LAS ROSAS","8409","ÑIQUEN","2","3","5"
"3815","ESCUELA PUERTAS DE VIRGUIN","8409","ÑIQUEN","7","7","14"
"3820","ESCUELA BULI-CASERIO","8409","ÑIQUEN","5","4","9"
"3823","LICEO JORGE ALESSANDRI RODRIGUEZ","8417","SAN FABIAN","18","29","47"
"3831","ESCUELA BASICA PASO ANCHO","8417","SAN FABIAN","3","12","15"
"3835","ESCUELA BRITANICA GUILLERMINA DRAKE WOOD","8405","COIHUECO","29","34","63"
"3836","ESCUELA DOMITILA URREJOLA MENCHACA","8405","COIHUECO","4","6","10"
"3837","ESCUELA ENRIQUE GRAF REYES","8405","COIHUECO","1","3","4"
"3838","ESCUELA BASICA TANILVORO","8405","COIHUECO","3","3","6"
"3839","ESCUELA TALQUIPEN","8405","COIHUECO","13","15","28"
"3840","ESCUELA BASICA NIBLINTO","8405","COIHUECO","4","12","16"
"3841","ESCUELA GUARDIA MARINA ERNESTO RIQUELME","8405","COIHUECO","8","14","22"
"3842","ESCUELA HEROES DE IQUIQUE","8405","COIHUECO","5","9","14"
"3843","ESCUELA PORVENIR DE CATO","8405","COIHUECO","17","16","33"
"3849","ESCUELA CAMILO HENRIQUEZ","8401","CHILLAN","5","11","16"
"3855","ESCUELA GENERAL PEDRO LAGOS MARCHANT","8405","COIHUECO","3","15","18"
"3856","ESCUELA MANUEL MATUS HERMOSILLA","8405","COIHUECO","8","9","17"
"3857","ESCUELA BENJAMIN VICUNA MACKENNA","8405","COIHUECO","2","1","3"
"3859","ESCUELA SAN ANTONIO DE FRUTILLARES","8405","COIHUECO","2","0","2"
"3872","ESCUELA JOSE TOHA SOLDEVILLA","8411","PINTO","7","12","19"
"3886","LICEO MANUEL JESUS ORTIZ","8418","SAN IGNACIO","11","9","20"
"3887","LICEO PUEBLO SECO","8418","SAN IGNACIO","18","33","51"
"3888","COLEGIO POLITECNICO VICTOR JARA","8418","SAN IGNACIO","8","10","18"
"3890","ESCUELA MARÍA LUISA ESPINOZA RUIZ","8418","SAN IGNACIO","7","10","17"
"3891","ESCUELA LAS QUILAS","8418","SAN IGNACIO","2","3","5"
"3897","ESCUELA CALLE ALEGRE","8418","SAN IGNACIO","3","5","8"
"3898","ESCUELA SANTA JUANA","8418","SAN IGNACIO","2","1","3"
"3899","ESCUELA COLTON VARIANTE","8418","SAN IGNACIO","3","4","7"
"3903","ESCUELA MAYULERMO","8418","SAN IGNACIO","6","1","7"
"3906","ESCUELA SELVA NEGRA","8418","SAN IGNACIO","0","2","2"
"3910","ESCUELA VIRGEN DEL CARMEN","8407","EL CARMEN","44","46","90"
"3912","ESCUELA DEL CARMEN SAN MARTÍN OTÁROLA","8407","EL CARMEN","7","1","8"
"3913","ESCUELA NAVIDAD-TREHUALEMU","8407","EL CARMEN","10","4","14"
"3914","ESCUELA BERNARDINO MUNOZ GONZALEZ","8407","EL CARMEN","2","2","4"
"3916","ESCUELA CAPILLA NORTE","8407","EL CARMEN","4","2","6"
"3918","ESCUELA LUIS TEODORO ORTEGA OYARCE","8407","EL CARMEN","2","3","5"
"3922","ESCUELA MATA REDONDA","8407","EL CARMEN","3","2","5"
"3935","ESCUELA DE SAN VICENTE ALTO","8407","EL CARMEN","6","2","8"
"3941","LICEO CAMPANARIO","8421","YUNGAY","27","30","57"
"3955","ESCUELA BASICA RANCHILLOS","8421","YUNGAY","7","1","8"
"3957","ESCUELA LOS MAYOS","8421","YUNGAY","4","6","10"
"3967","ESCUELA BASICA GENERAL CRUZ","8410","PEMUCO","6","7","13"
"3971","ESCUELA JOSÉ RENÉ SALGADO","8410","PEMUCO","5","5","10"
"3972","ESCUELA ARTURO MATTE ALESSANDRI","8410","PEMUCO","9","3","12"
"3974","ESCUELA BASICA VALLE HERMOSO","8410","PEMUCO","4","5","9"
"3977","LICEO SANTA CRUZ DE LARQUI","8402","BULNES","22","32","54"
"3978","ESCUELA CELIA URRUTIA PRIETO","8402","BULNES","9","8","17"
"3980","ESCUELA BASICA PUEBLO SECO SANTA CLARA","8402","BULNES","11","14","25"
"3981","ESCUELA EL PALPAL DE SANTA CLARA","8402","BULNES","11","11","22"
"3982","ESCUELA BATALLA DEL ROBLE","8402","BULNES","5","9","14"
"3983","ESCUELA EVARISTA OGALDE ORTEGA","8402","BULNES","8","12","20"
"3984","ESCUELA CANTA RANA","8402","BULNES","6","4","10"
"3991","ESCUELA COLTON QUILLAY","8402","BULNES","1","1","2"
"3999","ESCUELA BASICA HEROES DEL ITATA","8413","QUILLON","25","30","55"
"4000","ESCUELA BÁSICA AMANDA CHÁVEZ NAVARRETE","8413","QUILLON","24","39","63"
"4001","ESCUELA PEDRO ENRIQUE TORRES SABELLE","8413","QUILLON","1","3","4"
"4002","ESCUELA BASICA EL CASINO","8413","QUILLON","8","13","21"
"4005","ESCUELA BÁSICA PUERTO LOS FRUTALES DE COYANCO","8413","QUILLON","7","4","11"
"4006","ESCUELA BASICA LIUCURA BAJO","8413","QUILLON","3","1","4"
"4019","ESCUELA BÁSICA LAGUNA AVENDAÑO","8413","QUILLON","8","12","20"
"4026","ESCUELA BASICA NUEVA ALDEA","8415","RANQUIL","2","1","3"
"4027","ESCUELA BASICA VEGAS DE CONCHA","8415","RANQUIL","4","7","11"
"4029","ESCUELA BASICA SAN IGNACIO DE PALOMARES","8415","RANQUIL","6","6","12"
"4032","LICEO NIBALDO SEPULVEDA FERNANDEZ","8412","PORTEZUELO","14","14","28"
"4034","ESCUELA LOMAS DE CHUDAL","8412","PORTEZUELO","2","5","7"
"4039","ESCUELA SAN FRANCISCO DE ASIS","8412","PORTEZUELO","1","0","1"
"4048","ESCUELA VILLA JESUS DE COELEMU","8404","COELEMU","21","25","46"
"4050","ESCUELA MARIA TERESA MARCHANT CONTRERAS","8404","COELEMU","22","36","58"
"4051","ESCUELA CLEMENTINA MAUREIRA ALMANZA","8404","COELEMU","14","3","17"
"4052","ESCUELA GUARILIHUE ALTO","8404","COELEMU","6","6","12"
"4059","ESCUELA FELIPE CUBILLOS SIGAL","8404","COELEMU","1","2","3"
"4061","ESCUELA BASICA AMERICA","8415","RANQUIL","2","5","7"
"4062","ESCUELA VEGAS DE ITATA","8404","COELEMU","1","2","3"
"4070","ESCUELA BASICA MAITENCO","8420","TREGUACO","8","7","15"
"4071","ESCUELA BÁSICA VALLE LONQUÉN","8420","TREGUACO","17","25","42"
"4076","ESCUELA BASICA MINAS DE LEUQUE","8420","TREGUACO","4","4","8"
"4087","ESCUELA BASICA BUCHUPUREO","8403","COBQUECURA","4","6","10"
"4090","ESCUELA BASICA COLMUYAO","8403","COBQUECURA","0","2","2"
"4094","ESCUELA BASICA TAUCU","8403","COBQUECURA","1","4","5"
"4103","ESCUELA GRUMETE CORTES","8414","QUIRIHUE","17","17","34"
"4104","ESCUELA NUEVA AMERICA","8414","QUIRIHUE","25","19","44"
"4107","ESCUELA BASICA SANTA CAROLINA","8414","QUIRIHUE","2","4","6"
"4112","ESCUELA BASICA SANTA ELENA","8414","QUIRIHUE","0","3","3"
"4125","ESCUELA ROSARIO CHACON BARRIOS","8408","NINHUE","1","2","3"
"4128","ESCUELA BASICA DE RELOCA","8408","NINHUE","2","2","4"
"4130","ESCUELA BASICA EL RINCON","8408","NINHUE","1","1","2"
"4131","ESCUELA DOCTOR DAVID BENAVENTE SEPÚLVEDA","8408","NINHUE","3","3","6"
"4133","ESCUELA ALIPIA ACEVEDO","8408","NINHUE","1","3","4"
"4134","ESCUELA BASICA TALHUAN","8408","NINHUE","3","5","8"
"4140","LICEO BICENTENARIO DE EXCELENCIA POLIVALENTE SAN NICOLÁS","8419","SAN NICOLAS","67","57","124"
"4141","LICEO TÉCNICO PUENTE ÑUBLE","8419","SAN NICOLAS","7","11","18"
"4142","ESCUELA LA MERCED","8416","SAN CARLOS","1","2","3"
"4163","LICEO LOS ÁNGELES A-59","8301","LOS ANGELES","160","121","281"
"4164","LICEO COEDUCACIONAL SANTA MARÍA DE LOS ÁNGELES","8301","LOS ANGELES","27","20","47"
"4168","ESCUELA GENERAL BERNARDO O HIGGINS","8301","LOS ANGELES","0","39","39"
"4169","ESCUELA ESPANA","8301","LOS ANGELES","24","29","53"
"4171","ESCUELA COLONIA ARABE","8301","LOS ANGELES","23","23","46"
"4172","ESCUELA GENERAL JOSE DE SAN MARTIN","8301","LOS ANGELES","70","0","70"
"4173","ESCUELA BLANCO ENCALADA","8301","LOS ANGELES","12","43","55"
"4174","ESCUELA HOGAR NIEVES VASQUEZ PALACIOS","8301","LOS ANGELES","23","27","50"
"4175","ESCUELA THOMAS JEFFERSON","8301","LOS ANGELES","7","12","19"
"4176","ESCUELA JOSE MANSO DE VELASCO","8301","LOS ANGELES","73","0","73"
"4177","ESCUELA CLARA REBOLLEDO DE GODOY","8301","LOS ANGELES","5","9","14"
"4179","ESCUELA PEDRO RUIZ ALDEA","8301","LOS ANGELES","28","36","64"
"4180","ESCUELA ARTURO ALESSANDRI PALMA","8301","LOS ANGELES","8","16","24"
"4181","ESCUELA BASICA REPUBLICA DE ISRAEL","8301","LOS ANGELES","6","18","24"
"4183","ESCUELA BASICA 21 DE MAYO","8301","LOS ANGELES","12","11","23"
"4185","ESCUELA ISLA DE LAJA","8301","LOS ANGELES","35","22","57"
"4186","ESCUELA BASICA REPUBLICA DE ALEMANIA","8301","LOS ANGELES","8","9","17"
"4188","ESCUELA REPUBLICA DE GRECIA","8301","LOS ANGELES","6","5","11"
"4189","ESCUELA BASICA 11 DE SEPTIEMBRE","8301","LOS ANGELES","5","14","19"
"4190","LICEO SANTA FE","8301","LOS ANGELES","24","22","46"
"4191","ESCUELA BASICA SANTA CLARA DE CHACAYAL","8301","LOS ANGELES","6","11","17"
"4193","ESCUELA BASICA LOS MOLINOS","8301","LOS ANGELES","3","4","7"
"4194","ESCUELA BASICA LA QUEBRADA","8301","LOS ANGELES","6","9","15"
"4195","LICEO AGROINDUSTRIAL LLANO BLANCO","8301","LOS ANGELES","23","20","43"
"4197","ESCUELA CORONEL GUILLERMO MARIN CARMONA","8301","LOS ANGELES","3","11","14"
"4199","ESCUELA BASICA LA AGUADA DE CUEL","8301","LOS ANGELES","11","5","16"
"4200","ESCUELA BASICA VIRQUENCO","8301","LOS ANGELES","16","16","32"
"4201","ESCUELA BÁSICA HITILHUE","8301","LOS ANGELES","10","16","26"
"4202","ESCUELA BASICA LOS TRONCOS","8301","LOS ANGELES","0","1","1"
"4204","ESCUELA BASICA MILLANTU","8301","LOS ANGELES","11","10","21"
"4205","ESCUELA DIEGO PORTALES PALAZUELOS","8301","LOS ANGELES","15","10","25"
"4207","ESCUELA BÁSICA LA RINCONADA DEL SALTO","8301","LOS ANGELES","7","6","13"
"4210","ESCUELA BASICA COYANCO","8301","LOS ANGELES","1","2","3"
"4221","ESCUELA BASICA LA CAPILLA","8301","LOS ANGELES","5","7","12"
"4231","ESCUELA BASICA LA LEYENDA","8301","LOS ANGELES","5","6","11"
"4235","ESCUELA BASICA EL AMANECER DE DUQUECO","8301","LOS ANGELES","8","11","19"
"4254","ESCUELA PUENTE PERALES","8304","LAJA","12","5","17"
"4255","ESCUELA BASICA EL NOGAL.","8301","LOS ANGELES","5","8","13"
"4290","ESCUELA CHARRUA","8303","CABRERO","7","9","16"
"4292","ESCUELA SALTO EL LAJA","8303","CABRERO","12","11","23"
"4310","ESCUELA BASICA TUCAPEL","8312","TUCAPEL","22","21","43"
"4311","ESCUELA LOS AVELLANOS","8312","TUCAPEL","6","5","11"
"4312","ESCUELA ALEJANDRO PEREZ URBANO","8312","TUCAPEL","3","6","9"
"4324","LICEO  DOCTOR VÍCTOR RÍOS RUIZ","8302","ANTUCO","29","33","62"
"4331","LICEO FRANCISCO BASCUNAN GUERRERO","8309","QUILLECO","24","23","47"
"4333","LICEO ISABEL RIQUELME","8309","QUILLECO","15","11","26"
"4334","ESCUELA BASICA VILLA MERCEDES","8309","QUILLECO","10","14","24"
"4348","ESCUELA BASICA EL ESFUERZO","8309","QUILLECO","3","2","5"
"4352","ESCUELA BÁSICA ENRIQUE BERNSTEIN CARABANTES","8311","SANTA BARBARA","22","25","47"
"4354","ESCUELA DE CONCENTRACIÓN FRONTERIZA RALCO ALTO BIOBÍO","8314","ALTO BIOBIO","17","16","33"
"4355","ESCUELA DE EDUCACIÓN GENERAL BÁSICA EL HUACHI","8311","SANTA BARBARA","1","4","5"
"4356","ESCUELA LOS BOLDOS","8311","SANTA BARBARA","6","7","13"
"4357","ESCUELA BASICA VILLACURA","8311","SANTA BARBARA","5","4","9"
"4358","ESCUELA MARIANO PUGA VEGA","8311","SANTA BARBARA","3","6","9"
"4372","ESCUELA QUILLAILEO","8311","SANTA BARBARA","7","1","8"
"4375","ESCUELA RALCO LEPOY","8314","ALTO BIOBIO","12","9","21"
"4392","INSTITUTO VALLE DEL SOL QUILACO","8308","QUILACO","7","8","15"
"4393","ESCUELA BASICA RUCALHUE","8308","QUILACO","2","6","8"
"4396","ESCUELA BASICA CAMPAMENTO","8308","QUILACO","1","0","1"
"4402","ESCUELA BASICA LONCOPANGUE","8308","QUILACO","3","2","5"
"4405","ESCUELA BLANCO ENCALADA","8305","MULCHEN","27","24","51"
"4406","ESCUELA BASICA MULCHEN","8305","MULCHEN","47","39","86"
"4407","ESCUELA IGNACIO VERDUGO CAVADA","8305","MULCHEN","19","15","34"
"4408","LICEO CRISOL","8305","MULCHEN","7","14","21"
"4409","ESCUELA SACERDOTE ALEJANDRO MANERA","8305","MULCHEN","8","12","20"
"4410","ESCUELA BASICA VILLA LAS PENAS","8305","MULCHEN","11","16","27"
"4414","ESCUELA BASICA MUNILQUE IZAURIETA","8305","MULCHEN","7","8","15"
"4437","ESCUELA BASICA AURORA DE ENERO","8305","MULCHEN","2","4","6"
"4446","LICEO POLIVALENTE LA FRONTERA","8307","NEGRETE","35","35","70"
"4447","ESCUELA BASICA RIHUE","8307","NEGRETE","9","12","21"
"4448","ESCUELA BASICA VILLA COIGUE","8307","NEGRETE","12","16","28"
"4449","ESCUELA BASICA VAQUERIA","8307","NEGRETE","11","10","21"
"4452","ESCUELA EL SABER","8306","NACIMIENTO","38","37","75"
"4453","ESCUELA OSCAR GUERRERO QUINSAC","8306","NACIMIENTO","13","22","35"
"4454","ESCUELA CANADA","8306","NACIMIENTO","24","25","49"
"4455","ESCUELA TOQUI LAUTARO","8306","NACIMIENTO","29","33","62"
"4456","ESCUELA BASICA DOLLINCO","8306","NACIMIENTO","9","7","16"
"4481","ESCUELA JOSE ABELARDO NUNEZ","8304","LAJA","24","19","43"
"4482","ESCUELA NIVEQUETEN","8304","LAJA","45","37","82"
"4484","ESCUELA BASICA LA COLONIA","8304","LAJA","5","4","9"
"4485","ESCUELA FRANCISCO PEDRO ZATTERA GUELFI","8304","LAJA","7","9","16"
"4486","ESCUELA LAS CIÉNAGAS","8304","LAJA","3","2","5"
"4500","LICEO ISIDORA AGUIRRE TUPPER","8310","SAN ROSENDO","7","12","19"
"4503","ESCUELA BASICA LOS CALLEJONES","8310","SAN ROSENDO","3","1","4"
"4506","ESCUELA HÉROES DE CHILE","8313","YUMBEL","26","33","59"
"4507","LICEO TÉCNICO PROFESIONAL GONZALO GUGLIELMI MONTIEL","8313","YUMBEL","20","25","45"
"4509","LICEO MUNICIPAL RIO CLARO","8313","YUMBEL","7","12","19"
"4512","ESCUELA ENRIQUE PUFFE KIND","8313","YUMBEL","6","7","13"
"4513","ESCUELA PADRE PEDRO CAMPOS MENCHACA","8313","YUMBEL","5","5","10"
"4514","ESCUELA MUNICIPAL RERE","8313","YUMBEL","5","5","10"
"4531","COLEGIO MARINA DE CHILE","8101","CONCEPCION","47","30","77"
"4548","COLEGIO BIOBÍO","8101","CONCEPCION","7","18","25"
"4551","ESCUELA BÁSICA COMÚN HOSPITAL","8101","CONCEPCION","1","4","5"
"4555","LICEO ENRIQUE MOLINA GARMENDIA","8101","CONCEPCION","0","6","6"
"4557","LICEO EXPERIMENTAL LUCILA GODOY ALCAYAGA","8101","CONCEPCION","5","5","10"
"4558","LICEO DE ADULTOS JOSÉ MANUEL BALMACEDA FERNÁNDEZ","8101","CONCEPCION","14","10","24"
"4561","LICEO JUAN MARTINEZ DE ROZAS","8101","CONCEPCION","2","12","14"
"4562","LICEO SAN PEDRO","8108","SAN PEDRO DE LA PAZ","4","8","12"
"4563","LICEO REPÚBLICA DEL ECUADOR","8101","CONCEPCION","7","3","10"
"4564","COLEGIO BICENTENARIO REPÚBLICA DEL BRASIL","8101","CONCEPCION","63","66","129"
"4565","LICEO DOMINGO SANTA MARÍA","8101","CONCEPCION","18","19","37"
"4569","ESCUELA DIEGO PORTALES PALAZUELOS","8101","CONCEPCION","13","14","27"
"4571","LICEO JOSE HIPOLITO SALAS Y TORO","8103","CHIGUAYANTE","6","16","22"
"4572","COLEGIO GRAN BRETAÑA","8101","CONCEPCION","13","27","40"
"4574","COLEGIO ESPAÑA","8101","CONCEPCION","49","0","49"
"4575","ESCUELA BASICA JOHN F. KENNEDY","8103","CHIGUAYANTE","22","26","48"
"4576","ESCUELA BELGICA","8103","CHIGUAYANTE","15","17","32"
"4577","LICEO REPÚBLICA DE ISRAEL","8101","CONCEPCION","2","7","9"
"4578","ESCUELA DARIO SALAS MARCHANT","8108","SAN PEDRO DE LA PAZ","32","28","60"
"4579","ESCUELA BASICA RENE LOUVEL BERT","8101","CONCEPCION","21","26","47"
"4581","ESCUELA OSCAR CASTRO ZUNIGA","8101","CONCEPCION","6","5","11"
"4582","ESCUELA ESTHER HUNNEUS DE CLARO","8101","CONCEPCION","10","6","16"
"4584","ESCUELA REPUBLICA FEDERAL ALEMANA","8103","CHIGUAYANTE","6","8","14"
"4585","LICEO REBECA MATTE BELLO","8101","CONCEPCION","14","15","29"
"4586","ESCUELA BASICA MANQUIMAVIDA","8103","CHIGUAYANTE","14","24","38"
"4588","COLEGIO JUAN GREGORIO LAS HERAS","8101","CONCEPCION","38","58","96"
"4589","LICEO LUCERO GONZALEZ","8101","CONCEPCION","11","12","23"
"4591","ESCUELA BASICA REPUBLICA DE GRECIA","8103","CHIGUAYANTE","17","28","45"
"4592","ESCUELA BÁSICA IRENE FREI DE CID","8101","CONCEPCION","4","6","10"
"4593","BASICA SARGENTO CANDELARIA PEREZ","8108","SAN PEDRO DE LA PAZ","12","20","32"
"4594","ESCUELA MIGUEL JOSE ZANARTU SANTA MARIA","8108","SAN PEDRO DE LA PAZ","32","30","62"
"4595","ESCUELA ENRIQUE SORO BARRIGA","8108","SAN PEDRO DE LA PAZ","26","29","55"
"4603","ESCUELA BASICA LAGOS DE CHILE","8101","CONCEPCION","1","6","7"
"4609","ESCUELA PALESTINA DE PALOMARES","8101","CONCEPCION","11","8","19"
"4611","ESCUELA BASICA LUIS ALBERTO ACEVEDO","8108","SAN PEDRO DE LA PAZ","9","16","25"
"4612","ESCUELA LUIS ALFREDO MUÑOZ BURBOA","8101","CONCEPCION","3","9","12"
"4613","ESCUELA BASICA LAUTARO","8101","CONCEPCION","5","6","11"
"4614","ESCUELA BASICA AGUA DE LA GLORIA","8101","CONCEPCION","15","10","25"
"4615","ESCUELA BASICA BOCA DEL BIO BIO SUR","8108","SAN PEDRO DE LA PAZ","13","32","45"
"4616","ESCUELA BASICA  MICHAIHUE","8108","SAN PEDRO DE LA PAZ","19","29","48"
"4617","COLEGIO GALVARINO DE LOMAS COLORADAS","8108","SAN PEDRO DE LA PAZ","9","17","26"
"4622","ESCUELA BASICA FUNDO CHANCO","8101","CONCEPCION","4","1","5"
"4711","ARTURO PRAT CHACON","8110","TALCAHUANO","16","20","36"
"4712","ESCUELA SANTA LEONOR","8110","TALCAHUANO","17","25","42"
"4713","ESCUELA THOMAS JEFFERSON D 465","8112","HUALPEN","24","52","76"
"4714","ESCUELA HELEN KELLER ADAMS","8112","HUALPEN","52","0","52"
"4715","LICEO SIMÓN BOLÍVAR","8112","HUALPEN","4","6","10"
"4717","LICEO TÉCNICO PROFESIONAL LUCILA GODOY ALCAYAGA","8112","HUALPEN","4","13","17"
"4719","ESCUELA REPUBLICA DEL PERU","8112","HUALPEN","23","14","37"
"4720","ESCUELA D N° 475","8110","TALCAHUANO","7","9","16"
"4722","ESCUELA BLANCA ESTELA PRAT CARVAJAL","8112","HUALPEN","24","31","55"
"4723","ESCUELA MEXICO ESTADO DE GUERRERO","8110","TALCAHUANO","0","89","89"
"4724","ESCUELA BASICA LA DAMA BLANCA","8110","TALCAHUANO","76","0","76"
"4725","ESCUELA VILLA INDEPENDENCIA","8110","TALCAHUANO","16","17","33"
"4726","ESCUELA BASICA LAS HIGUERAS","8110","TALCAHUANO","13","14","27"
"4727","COLEGIO HUACHIPATO","8110","TALCAHUANO","9","8","17"
"4728","COLEGIO LOS CONDORES","8110","TALCAHUANO","25","35","60"
"4730","ESCUELA ALONKURA","8112","HUALPEN","18","21","39"
"4731","ESCUELA BÁSICA CRISTÓBAL COLÓN","8112","HUALPEN","6","5","11"
"4732","ESCUELA BASICA CRUZ DEL SUR","8110","TALCAHUANO","31","35","66"
"4733","LICEO ANITA SERRANO SEPULVEDA","8110","TALCAHUANO","26","0","26"
"4734","ESCUELA BASICA LIBERTAD","8110","TALCAHUANO","21","7","28"
"4736","ESCUELA CORNETA CABRALES","8110","TALCAHUANO","19","22","41"
"4737","COLEGIO BASICO VILLA ACERO","8112","HUALPEN","39","52","91"
"4740","C.E.I.A.  HUALPENCILLO","8112","HUALPEN","9","3","12"
"4742","COLEGIO REMODELACION SIMONS","8110","TALCAHUANO","12","33","45"
"4744","ESCUELA BASICA  CERRO CORNOU","8110","TALCAHUANO","7","6","13"
"4746","ESCUELA BASICA BUENA VISTA","8110","TALCAHUANO","11","16","27"
"4747","ESCUELA F 500 HUERTOS FAMILIARES","8110","TALCAHUANO","8","9","17"
"4748","ESCUELA REPUBLICA BOLIVARIANA DE VENEZUELA","8110","TALCAHUANO","1","5","6"
"4750","ESCUELA SANTA CLARA","8110","TALCAHUANO","5","11","16"
"4753","ESCUELA BASICA PENINSULA DE TUMBES","8110","TALCAHUANO","9","10","19"
"4754","ESCUELA BASICA CERRO SAN FRANCISCO","8110","TALCAHUANO","58","66","124"
"4806","ESCUELA REPUBLICA DE ITALIA","8107","PENCO","9","16","25"
"4807","ESCUELA ISLA DE PASCUA","8107","PENCO","35","35","70"
"4808","ESCUELA PENCO","8107","PENCO","9","8","17"
"4809","ESCUELA EDUARDO CAMBELL SAAVEDRA","8107","PENCO","5","6","11"
"4810","ESCUELA ALMIRANTE JORGE MONTT ÁLVAREZ","8107","PENCO","18","19","37"
"4811","ESCUELA ALMIRANTE PATRICIO LYNCH","8107","PENCO","22","20","42"
"4812","ESCUELA LA GREDA","8107","PENCO","9","8","17"
"4813","ESCUELA VIPLA","8107","PENCO","9","15","24"
"4814","ESCUELA ETHEL HENCK DE GRANT","8107","PENCO","13","15","28"
"4830","ESCUELA BÁSICA REPÚBLICA DE ECUADOR","8111","TOME","57","60","117"
"4831","ESCUELA BASICA BELLAVISTA","8111","TOME","19","17","36"
"4832","ESCUELA BASICA IGNACIO SERRANO MONTANER","8111","TOME","6","3","9"
"4834","ESCUELA BASICA DICHATO","8111","TOME","29","26","55"
"4835","ESCUELA BASICA ARTURO PRAT","8111","TOME","27","16","43"
"4836","ESCUELA BASICA REPUBLICA DE PANAMA","8111","TOME","8","11","19"
"4837","ESCUELA BASICA RAFAEL","8111","TOME","11","10","21"
"4838","ESCUELA BASICA CARLOS MAHNS CHOUPAY","8111","TOME","5","12","17"
"4839","ESCUELA BASICA COCHOLGUE","8111","TOME","6","9","15"
"4840","ESCUELA BASICA Y ADULTOS CALIFORNIA","8111","TOME","6","8","14"
"4841","ESCUELA BASICA CERRO ESTANQUE","8111","TOME","7","15","22"
"4842","ESCUELA MARIANO EGANA","8111","TOME","6","10","16"
"4843","ESCUELA BÁSICA LISA ENRIQUETA PETER TEUBNER","8111","TOME","13","12","25"
"4844","ESCUELA BASICA MENQUE","8111","TOME","0","1","1"
"4845","ESCUELA BASICA PUNTA DE PARRA","8111","TOME","3","7","10"
"4848","ESCUELA BASICA SAN CARLITOS","8111","TOME","5","7","12"
"4852","ESCUELA BASICA CALETA DEL MEDIO","8111","TOME","3","6","9"
"4860","ESCUELA BASICA VEGAS DE COLIUMO","8111","TOME","7","3","10"
"4869","ESCUELA BASICA FLORIDA","8104","FLORIDA","21","29","50"
"4871","LICEO COPIULEMU","8104","FLORIDA","15","11","26"
"4873","ESCUELA RAHUIL","8104","FLORIDA","12","9","21"
"4890","ESCUELA BASICA VILLAMAVIDA","8104","FLORIDA","4","5","9"
"4898","ESCUELA MANUEL AMAT Y JUNIET","8105","HUALQUI","22","39","61"
"4902","ESCUELA CARLOS ALBERTO FERNÁNDEZ CASTILLO","8105","HUALQUI","6","13","19"
"4908","ESCUELA ALEJANDRO VARELA SANTA MARIA","8105","HUALQUI","2","2","4"
"4909","ESCUELA PROFESORA JUANA SALGADO PARRA DE UNIHUE","8105","HUALQUI","1","5","6"
"4926","ESCUELA RECAREDO VIGUERAS ARANEDA","8109","SANTA JUANA","10","20","30"
"4927","ESCUELA COLICO ALTO","8109","SANTA JUANA","4","3","7"
"4943","ESCUELA CHACAYAL","8109","SANTA JUANA","3","4","7"
"4946","ESCUELA LA GENERALA","8109","SANTA JUANA","3","2","5"
"4952","ESCUELA BALDOMERO LILLO FIGUEROA","8106","LOTA","32","27","59"
"4953","ESCUELA ISIDORA GOYENECHEA","8106","LOTA","16","18","34"
"4954","ESCUELA BASICA SANTA MARIA DE GUADALUPE","8106","LOTA","12","13","25"
"4955","ESCUELA BASICA KONRAD ADENAUER","8106","LOTA","8","17","25"
"4956","ESCUELA BASICA BELLO HORIZONTE","8106","LOTA","15","24","39"
"4958","ESCUELA BASICA THOMPSON MATTHEWS","8106","LOTA","39","39","78"
"4960","COLEGIO ANGEL DE PEREDO","8106","LOTA","39","33","72"
"4961","ESCUELA BASICA COLCURA","8106","LOTA","9","12","21"
"4965","C.E.I.A SAN LUIS DE POTOSI REPÚBLICA DE MÉXICO","8106","LOTA","11","5","16"
"4967","ESCUELA BASICA CENTENARIO","8106","LOTA","12","13","25"
"4968","ESCUELA BÁSICA CARABINERO ISAÍAS GUEVARA","8106","LOTA","4","11","15"
"4982","LICEO CORONEL ANTONIO SALAMANCA","8102","CORONEL","13","8","21"
"4983","LICEO YOBILO DE CORONEL","8102","CORONEL","20","23","43"
"4984","ESCUELA ROSITA RENARD","8102","CORONEL","17","20","37"
"4985","ESCUELA BASICA PLAYAS NEGRAS","8102","CORONEL","17","9","26"
"4986","ESCUELA ROSA MEDEL AGUILERA","8102","CORONEL","7","9","16"
"4987","ESCUELA BASICA JAVIERA CARRERA","8102","CORONEL","12","17","29"
"4988","ESCUELA RAFAEL SOTOMAYOR BAEZA","8102","CORONEL","42","42","84"
"4989","ESCUELA VICTOR DOMINGO SILVA","8102","CORONEL","13","21","34"
"4990","ESCUELA AMBROSIO O´HIGGINS","8102","CORONEL","19","7","26"
"4991","ESCUELA REPUBLICA DE FRANCIA","8102","CORONEL","8","14","22"
"4992","ESCUELA REMIGIO CASTRO ABURTO","8102","CORONEL","14","15","29"
"4994","ESCUELA ADELAIDA MIGUIELES SOTO","8102","CORONEL","23","20","43"
"4995","ESCUELA OCTAVIO SALINAS CARIAGA","8102","CORONEL","13","16","29"
"4996","ESCUELA VISTA HERMOSA","8102","CORONEL","12","14","26"
"4997","ESCUELA JORGE ROJAS MIRANDA","8102","CORONEL","12","13","25"
"4998","ESCUELA ROSA YANEZ RODRIGUEZ","8102","CORONEL","3","15","18"
"5001","ESCUELA ARTURO HUGHES CERNA","8102","CORONEL","36","46","82"
"5002","ESCUELA JUAN JOSE LATORRE BENAVENTE","8102","CORONEL","3","4","7"
"5003","ESCUELA FRANCISCO COLOANE","8102","CORONEL","6","11","17"
"5021","LICEO TÉCNICO PROFESIONAL DOCTOR RIGOBERTO IGLESIAS BASTÍAS DE LEBU","8201","LEBU","15","9","24"
"5024","LICEO ISIDORA RAMOS DE GAJARDO","8201","LEBU","88","62","150"
"5025","ESCUELA PROFESORA REBECA CASTRO ARANEDA","8201","LEBU","21","26","47"
"5026","ESCUELA FRESIA GRACIELA MULLER RUIZ","8201","LEBU","23","31","54"
"5033","ESCUELA ARTURO EBENSPERGER RICHTER","8201","LEBU","13","18","31"
"5034","ESCUELA LA FORTUNA","8201","LEBU","3","16","19"
"5035","ESCUELA ARMANDO ARANCIBIA OLIVOS","8201","LEBU","3","5","8"
"5039","ESCUELA GUILLERMO RODRIGUEZ  RIOBIO","8201","LEBU","9","6","15"
"5048","LICEO SAN FELIPE DE ARAUCO","8202","ARAUCO","24","32","56"
"5049","ESCUELA BASICA VICENTE MILLAN IRIARTE","8202","ARAUCO","11","12","23"
"5051","ESCUELA BÁSICA DE CARAMPANGUE","8202","ARAUCO","27","24","51"
"5052","ESCUELA LOS PINOS","8202","ARAUCO","7","16","23"
"5053","ESCUELA JORGE IVAN VALENZUELA ZUNIGA","8202","ARAUCO","6","10","16"
"5054","ESCUELA BASICA SAN PEDRO DE LARAQUETE","8202","ARAUCO","15","23","38"
"5055","ESCUELA VALLE RAMADILLAS","8202","ARAUCO","8","6","14"
"5057","LICEO TÉCNICO PESQUERO FILIDOR GAETE MONSÁLVEZ","8202","ARAUCO","2","4","6"
"5069","ESCUELA BASICA ALTO YANI","8202","ARAUCO","1","3","4"
"5070","ESCUELA BASICA VALLE VERDE","8202","ARAUCO","3","2","5"
"5073","ESCUELA BASICA BRISAS DEL MAR","8202","ARAUCO","11","19","30"
"5074","ESCUELA BASICA CESAR MONSALVE FLORES","8202","ARAUCO","5","3","8"
"5085","ESCUELA RAMIRO ROA GONZALEZ","8205","CURANILAHUE","53","56","109"
"5086","ESCUELA CUATRO DE OCTUBRE","8205","CURANILAHUE","7","9","16"
"5087","ESCUELA COLICO SUR","8205","CURANILAHUE","14","18","32"
"5088","ESCUELA PABLO NERUDA","8205","CURANILAHUE","36","65","101"
"5090","ESCUELA BUENA ESPERANZA","8205","CURANILAHUE","12","11","23"
"5091","ESCUELA GABRIELA MISTRAL","8205","CURANILAHUE","13","6","19"
"5093","ESCUELA INDEPENDENCIA","8205","CURANILAHUE","16","16","32"
"5097","ESCUELA BAJO LOS RIOS","8205","CURANILAHUE","2","1","3"
"5101","ESCUELA SAN JOSE DE COLICO","8205","CURANILAHUE","5","6","11"
"5106","ESCUELA FELIX EYHERAMENDY","8206","LOS ALAMOS","30","33","63"
"5109","ESCUELA CLAUDIO FLORES SOTO","8206","LOS ALAMOS","28","37","65"
"5110","ESCUELA PILPILCO","8206","LOS ALAMOS","4","13","17"
"5112","ESCUELA ZAIDA ARANEDA VIGUERAS","8206","LOS ALAMOS","9","13","22"
"5113","ESCUELA ORLANDO DELGADO ZUNIGA","8206","LOS ALAMOS","10","13","23"
"5116","ESCUELA JOSE M.CAMPOS MENCHACA","8206","LOS ALAMOS","1","3","4"
"5119","ESCUELA LAS DUNAS","8206","LOS ALAMOS","9","3","12"
"5121","ESCUELA JOSE ULLOA FIERRO","8206","LOS ALAMOS","7","8","15"
"5123","ESCUELA BASICA CACIQUE FRANCISCO MELIN","8203","CAÑETE","9","17","26"
"5127","ESCUELA LEONCIO ARANEDA FIGUEROA","8203","CAÑETE","0","54","54"
"5128","ESCUELA ARTURO PRAT CHACON","8203","CAÑETE","90","0","90"
"5129","ESCUELA BASICA RENE ANDRADES TOLEDO","8203","CAÑETE","20","19","39"
"5130","ESCUELA BASICA RUBI NELSON SILVA SALAS","8203","CAÑETE","8","12","20"
"5131","ESCUELA BÁSICA HOMERO VIGUERAS ARANEDA","8203","CAÑETE","14","16","30"
"5132","ESCUELA RICARDO COLOMA DIAZ","8203","CAÑETE","7","10","17"
"5133","ESCUELA BASICA LLONCAO","8203","CAÑETE","5","4","9"
"5134","ESCUELA BASICA LA GRANJA","8203","CAÑETE","9","10","19"
"5140","ESCUELA BASICA FEDERICO GANA","8203","CAÑETE","4","7","11"
"5145","ESCUELA BASICA GARCIA HURTADO DE MENDOZA","8203","CAÑETE","4","4","8"
"5154","ESCUELA SAN LUIS DE CONTULMO","8204","CONTULMO","25","33","58"
"5157","ESCUELA BASICA GALVARINO","8203","CAÑETE","9","5","14"
"5158","ESCUELA BASICA JUAN AGUILERA JEREZ","8203","CAÑETE","6","7","13"
"5166","ESCUELA CALEBU","8204","CONTULMO","8","8","16"
"5172","ESCUELA BASICA JUAN LAVIN ALVEAR","8203","CAÑETE","5","3","8"
"5178","ESCUELA BASICA PEDRO ETCHEPARE BORDA","8203","CAÑETE","0","3","3"
"5192","ESCUELA ANA MOLINA","8207","TIRUA","6","7","13"
"5193","ESCUELA HECTOR ISAAC CARRASCO HELDT","8207","TIRUA","11","8","19"
"5194","ESCUELA ELOISA GONZALEZ","8207","TIRUA","25","15","40"
"5196","ESCUELA PRIMER AGUA","8207","TIRUA","9","7","16"
"5197","ESCUELA CASA DE PIEDRA","8207","TIRUA","4","4","8"
"5202","ESCUELA MAPODUNGUN","8207","TIRUA","7","12","19"
"5203","ESCUELA AGUA DE MOLINO","8207","TIRUA","1","1","2"
"5205","ESCUELA CHILLIMAPU","8207","TIRUA","3","8","11"
"5218","LICEO ENRIQUE BALLACEY COTTEREAU","9201","ANGOL","18","12","30"
"5220","ESCUELA HERMANOS CARRERA","9201","ANGOL","22","19","41"
"5221","ESCUELA BASICA NAHUELBUTA","9201","ANGOL","15","15","30"
"5224","ESCUELA REPUBLICA FEDERAL ALEMANA","9201","ANGOL","12","13","25"
"5225","COLEGIO MARÍA SYLVESTER RASCH","9201","ANGOL","11","15","26"
"5226","ESCUELA DIEGO DUBLE URRUTIA","9201","ANGOL","35","29","64"
"5227","ESCUELA JOSÉ ELÍAS BOLIVAR HERRERA","9201","ANGOL","10","24","34"
"5228","ESCUELA VILLA HUEQUEN","9201","ANGOL","20","28","48"
"5229","ESCUELA BASICA ARAGON","9201","ANGOL","41","53","94"
"5233","ESCUELA BASICA JUAN M. FERRIERE CAIRE","9201","ANGOL","0","2","2"
"5248","ESCUELA REPUBLICA DE AUSTRIA","9201","ANGOL","4","2","6"
"5249","ESC. BASICA MANUEL RODRIGUEZ","9201","ANGOL","5","9","14"
"5250","ESCUELA REGIMIENTO HUSARES","9201","ANGOL","2","3","5"
"5270","LICEO POLITECNICO DOMINGO STA MARIA","9209","RENAICO","13","15","28"
"5272","ESCUELA BASICA LOS NOGALES","9209","RENAICO","10","8","18"
"5273","ESCUELA MUNICIP. LA NOBEL GABRIELA","9209","RENAICO","7","12","19"
"5274","LICEO AGRICOLA FORESTAL MANZANARES","9209","RENAICO","2","4","6"
"5283","ESCUELA THOMAS ALBA EDISON","9202","COLLIPULLI","29","27","56"
"5284","ESCUELA BENJAMIN FRANKLIN","9202","COLLIPULLI","17","34","51"
"5286","ESCUELA BASICA VICTOR DURAN PEREZ","9202","COLLIPULLI","25","27","52"
"5288","ESCUELA MICHIGAN EL AMANECER","9202","COLLIPULLI","16","16","32"
"5289","ESCUELA MININCO","9202","COLLIPULLI","28","21","49"
"5290","ESCUELA NICOLAS PEREZ CARDENAS","9202","COLLIPULLI","5","10","15"
"5292","ESCUELA BASICA MIGUEL HUENTELEN","9202","COLLIPULLI","22","18","40"
"5324","ESCUELA MUNICIPAL FRONTERIZA","9205","LONQUIMAY","14","17","31"
"5326","ESCUELA BASICA MALALMAHUIDA","9205","LONQUIMAY","6","3","9"
"5327","ESCUELA DE LIUCURA","9205","LONQUIMAY","8","7","15"
"5333","ESCUELA DE ICALMA","9205","LONQUIMAY","7","14","21"
"5344","LICEO LAS ARAUCARIAS","9203","CURACAUTIN","40","39","79"
"5345","ESCUELA LUIS CRUZ MARTINEZ","9203","CURACAUTIN","9","8","17"
"5346","ESCUELA OSVALDO FUENTES BARRERA","9203","CURACAUTIN","5","8","13"
"5347","ESCUELA PATRICIO CHAVEZ SOTO","9203","CURACAUTIN","19","16","35"
"5348","RAMON EDUARDO RAMIREZ HENRIQUEZ","9203","CURACAUTIN","3","2","5"
"5353","ESCUELA BASICA REPUBLICA DE MEXICO","9203","CURACAUTIN","7","10","17"
"5363","ESCUELA  BASICA ALEJO TASCON","9203","CURACAUTIN","3","3","6"
"5374","LICEO ALONSO DE ERCILLA Y ZUÑIGA","9204","ERCILLA","17","19","36"
"5375","ESCUELA BASICA SALVADOR ALLENDE","9204","ERCILLA","10","8","18"
"5378","ESCUELA BASICA TEODOCIO URRUTIA","9204","ERCILLA","6","8","14"
"5382","ESCUELA MILLALEVIA","9204","ERCILLA","2","5","7"
"5395","ESCUELA MARCELA PAZ","9211","VICTORIA","25","25","50"
"5396","COLEGIO IGNACIO CARRERA PINTO","9211","VICTORIA","16","15","31"
"5398","ESCUELA HEROES DE IQUIQUE","9211","VICTORIA","16","12","28"
"5404","ESCUELA HERNAN TRIZANO AVEZZANA","9211","VICTORIA","3","3","6"
"5406","ESCUELA SELVA OSCURA","9211","VICTORIA","9","12","21"
"5407","ESCUELA BASICA PATRICIO LINCH","9211","VICTORIA","7","6","13"
"5408","ESCUELA PAILAHUEQUE","9211","VICTORIA","6","8","14"
"5411","ESCUELA MUNICIPAL MONICA GEBERT MEIER","9211","VICTORIA","8","5","13"
"5422","ESCUELA BASICA LAS CARDAS","9211","VICTORIA","1","4","5"
"5425","ESCUELA BASICA SANTA ELENA","9211","VICTORIA","1","1","2"
"5439","COMPLEJO EDUCACIONAL LUIS DURAND DURAND","9210","TRAIGUEN","10","7","17"
"5440","LICEO LUCILA GODOY ALCAYAGA","9210","TRAIGUEN","10","8","18"
"5441","ESCUELA REPUBLICA DE ISRAEL","9210","TRAIGUEN","24","28","52"
"5442","ESCUELA BASICA EMILIA ROMAGNA","9210","TRAIGUEN","33","29","62"
"5446","ESCUELA DIEGO PORTALES","9210","TRAIGUEN","5","5","10"
"5462","ESC. BASICA REDUCCION TEMULEMU","9210","TRAIGUEN","2","2","4"
"5470","ESCUELA BASICA REPUBLICA DE ITALIA","9207","LUMACO","18","20","38"
"5471","ESCUELA F-174 VALLE DE LUMACO","9207","LUMACO","29","32","61"
"5472","ESC. MUNICIPAL PICHIPELLAHUEN","9207","LUMACO","5","7","12"
"5508","ESCUELA PEDRO DE ONA","9208","PUREN","41","38","79"
"5509","LICEO BICENTENARIO INDÓMITO DE PURÉN","9208","PUREN","24","14","38"
"5510","ESCUELA ENZO FERRARI","9208","PUREN","14","14","28"
"5538","ESCUELA GUSTAVO VASQUEZ DIAZ","9206","LOS SAUCES","19","12","31"
"5539","ESCUELA DE LOS SAUCES","9206","LOS SAUCES","9","20","29"
"5541","ESC. BASICA ELENA MULLER M.","9206","LOS SAUCES","0","2","2"
"5569","LICEO GABRIELA MISTRAL DE TEMUCO","9101","TEMUCO","12","16","28"
"5570","LICEO PABLO NERUDA","9101","TEMUCO","51","36","87"
"5575","ESCUELA ARTURO PRAT","9101","TEMUCO","24","45","69"
"5578","ESCUELA LLAIMA","9101","TEMUCO","46","52","98"
"5580","ESCUELA CAMPOS DEPORTIVOS","9101","TEMUCO","38","43","81"
"5582","ESCUELA STANDAR","9101","TEMUCO","14","17","31"
"5583","ESCUELA SANTA ROSA","9101","TEMUCO","11","11","22"
"5585","ESCUELA VILLA ALEGRE","9101","TEMUCO","8","14","22"
"5588","ESCUELA MANUEL RECABARREN","9101","TEMUCO","19","14","33"
"5589","ESCUELA MILLARAY","9101","TEMUCO","16","12","28"
"5590","COMPLEJO EDUC. UN AMANECER EN LA ARAUCANIA","9101","TEMUCO","22","27","49"
"5592","ESCUELA ANDRES BELLO","9101","TEMUCO","13","13","26"
"5596","COLEGIO MUNDO MAGICO","9101","TEMUCO","46","46","92"
"5597","ESCUELA ALONSO DE ERCILLA","9101","TEMUCO","32","39","71"
"5599","ESCUELA DARIO SALAS","9112","PADRE LAS CASAS","16","20","36"
"5604","ESCUELA PEDRO DE VALDIVIA","9101","TEMUCO","12","11","23"
"5606","ESCUELA VILLA CAROLINA","9101","TEMUCO","10","17","27"
"5608","ESCUELA LOS AVELLANOS","9101","TEMUCO","7","13","20"
"5611","ESCUELA LOS TRIGALES","9101","TEMUCO","17","26","43"
"5613","COMPLEJO EDUCACIONAL LA GRANJA","9119","VILCUN","17","24","41"
"5614","ESCUELA LABRANZA","9101","TEMUCO","14","11","25"
"5620","C.E.I.A. SELVA SAAVEDRA","9101","TEMUCO","7","9","16"
"5622","ESCUELA BÁSICA BERNARDO ÑANKO","9205","LONQUIMAY","10","14","24"
"5623","ESCUELA TRUMPULO CHICO","9112","PADRE LAS CASAS","4","1","5"
"5624","ESCUELA METRENCO","9112","PADRE LAS CASAS","13","11","24"
"5625","ESCUELA TRUF-TRUF.","9112","PADRE LAS CASAS","8","12","20"
"5627","ESCUELA LAUREL HUACHO","9112","PADRE LAS CASAS","2","2","4"
"5631","ESCUELA LICANCO","9112","PADRE LAS CASAS","8","6","14"
"5632","ESCUELA REDUCCION MONTE VERDE","9101","TEMUCO","1","2","3"
"5634","ESCUELA NIRRIMAPU","9112","PADRE LAS CASAS","8","5","13"
"5638","ESCUELA COLPANAO","9112","PADRE LAS CASAS","5","5","10"
"5640","ESCUELA MOLLULCO","9101","TEMUCO","4","4","8"
"5645","ESCUELA BOYECO","9101","TEMUCO","14","21","35"
"5646","ESCUELA CHOMIO","9112","PADRE LAS CASAS","3","8","11"
"5647","ESCUELA COLLIMALLIN","9101","TEMUCO","7","1","8"
"5648","ESCUELA CHAPOD","9112","PADRE LAS CASAS","2","1","3"
"5649","ESCUELA FUNDO MAQUEHUE","9112","PADRE LAS CASAS","5","11","16"
"5824","ESC. BASICA NUMERO SEIS","9108","LAUTARO","43","32","75"
"5825","ESC. BASICA AMELIA GODOY","9108","LAUTARO","3","8","11"
"5827","ESCUELA IRENE FREI","9108","LAUTARO","5","16","21"
"5828","ESC. BASICA GUACOLDA","9108","LAUTARO","14","21","35"
"5829","ESCUELA LOS CACHORROS","9108","LAUTARO","22","37","59"
"5831","LICEO LOS CASTANOS","9108","LAUTARO","7","4","11"
"5832","ESC. BASICA NIERECO","9108","LAUTARO","7","8","15"
"5833","ESC. BASICA REWE KIMUN","9108","LAUTARO","8","6","14"
"5847","ESC. BASICA SANTA YOLANDA","9108","LAUTARO","3","2","5"
"5852","ESC. BASICA EL ESCUDO","9108","LAUTARO","7","0","7"
"5854","ESC. BASICA VEGA LARGA","9108","LAUTARO","6","5","11"
"5879","LICEO ISABEL POBLETE V.","9113","PERQUENCO","38","31","69"
"5896","ESCUELA JAPON","9119","VILCUN","6","6","12"
"5897","COLEGIO AMERICA","9119","VILCUN","29","24","53"
"5899","ESCUELA DAGOBERTO GODOY","9119","VILCUN","5","8","13"
"5901","ESC. BASICA VEGA REDONDA","9119","VILCUN","6","9","15"
"5902","ESCUELA MARTIN ALONQUEO PIUTRIN","9119","VILCUN","7","16","23"
"5905","ESC. BASICA COLLIN ALTO","9119","VILCUN","7","6","13"
"5957","LICEO MUNICIPAL ATENEA","9103","CUNCO","22","19","41"
"5959","LICEO ARTURO VALENZUELA","9103","CUNCO","8","5","13"
"5960","ESCUELA BASICA LAS HORTENCIAS","9103","CUNCO","7","4","11"
"5970","ESCUELA VIDA Y PAZ","9103","CUNCO","4","4","8"
"5990","ESCUELA BASICA QUECHEREHUE","9103","CUNCO","7","6","13"
"6005","ESCUELA AURORA DE CHILE","9103","CUNCO","5","0","5"
"6027","COMPLEJO EDUCACIONAL MONSEÑOR FRCO. VALDES S","9104","CURARREHUE","16","17","33"
"6029","ESCUELA RUCA MANKE","9104","CURARREHUE","8","3","11"
"6030","ESCUELA JERONIMO NECULPAN","9104","CURARREHUE","3","4","7"
"6036","ESCUELA LICANCURA","9104","CURARREHUE","2","2","4"
"6052","ESCUELA CARLOS HOLZAFEL","9115","PUCON","17","31","48"
"6053","ESCUELA JOSE MIGUEL MARTINEZ SOTO","9115","PUCON","4","4","8"
"6056","ESCUELA BASICA MUNICIPAL DE EL CLARO","9115","PUCON","15","13","28"
"6060","ESC. BASICA VILLA SAN PEDRO","9115","PUCON","4","4","8"
"6066","ESC. BASICA CARILEUFU","9115","PUCON","10","10","20"
"6069","ESC.BASICA PAILLACO","9115","PUCON","8","10","18"
"6084","LICEO BICENTENARIO ARAUCANÍA","9120","VILLARRICA","43","26","69"
"6086","ESCUELA JOSE ABELARDO NUNEZ","9120","VILLARRICA","15","17","32"
"6087","ESCUELA ALEXANDER GRAHAM BELL","9120","VILLARRICA","19","21","40"
"6088","ESCUELA VALENTIN LETELIER","9120","VILLARRICA","17","19","36"
"6089","ESCUELA VOIPIR DE NANCUL","9120","VILLARRICA","5","11","16"
"6090","ESCUELA MARIANO LATORRE","9120","VILLARRICA","15","23","38"
"6092","ESCUELA EPUKLEI","9120","VILLARRICA","6","6","12"
"6093","ESCUELA MOLCO ALTO","9120","VILLARRICA","1","2","3"
"6107","ESCUELA CONQUIL","9120","VILLARRICA","0","1","1"
"6108","ESCUELA MANANTIAL","9120","VILLARRICA","3","4","7"
"6164","ESCUELA JUAN SEGUEL","9105","FREIRE","20","27","47"
"6165","ESCUELA RAIMAPU","9105","FREIRE","18","20","38"
"6166","ESCUELA LA ESPERANZA","9105","FREIRE","5","10","15"
"6170","ESCUELA ARMANDO QUINTULEN","9105","FREIRE","3","5","8"
"6178","ESCUELA BASICA QUETROCO","9105","FREIRE","2","2","4"
"6179","ESCUELA RURAL EL LLIUCO","9105","FREIRE","1","4","5"
"6181","ESCUELA COIPUE","9105","FREIRE","8","3","11"
"6183","ESCUELA ALLIPEN","9105","FREIRE","6","5","11"
"6223","LICEO DE CIENCIAS Y HUMANIDADES","9114","PITRUFQUEN","2","6","8"
"6224","ESCUELA UNION LATINOAMERICANA","9114","PITRUFQUEN","30","28","58"
"6225","ESCUELA JUAN BTA. CHESTA CH.","9114","PITRUFQUEN","13","15","28"
"6227","ESCUELA LAS AMERICAS","9114","PITRUFQUEN","10","7","17"
"6230","LICEO MUNICIPAL LA FRONTERA","9114","PITRUFQUEN","8","13","21"
"6231","ESC. BASICA LOS GALPONES","9114","PITRUFQUEN","1","5","6"
"6237","ESCUELA NUEVO HORIZONTE","9114","PITRUFQUEN","2","2","4"
"6251","ESCUELA RESERVA FORESTAL MAHUIDANCHI","9114","PITRUFQUEN","1","2","3"
"6270","LICEO JOSE VICTORINO LASTARRIA","9107","GORBEA","12","6","18"
"6271","ESCUELA BASICA CINCO","9107","GORBEA","5","12","17"
"6272","ESCUELA BASICA LICARAYEN","9107","GORBEA","13","7","20"
"6273","ESC.PRESBITERO JOSE AGUSTIN GOMEZ Z.","9107","GORBEA","29","19","48"
"6285","ESCUELA BASICA LOS PERALES","9107","GORBEA","13","21","34"
"6302","LICEO BICENTENARIO PADRE ALBERTO HURTADO CRUCHAGA","9109","LONCOCHE","34","19","53"
"6303","ESCUELA EGON ERNTS KEUTMANN BESGEN","9109","LONCOCHE","7","8","15"
"6304","ESCUELA ALBORADA","9109","LONCOCHE","44","68","112"
"6305","ESCUELA DOMITILA PINNA PARRA","9109","LONCOCHE","11","6","17"
"6319","ESCUELA ESMERALDA","9109","LONCOCHE","2","1","3"
"6349","ESCUELA AGUAS Y GAVIOTAS","9118","TOLTEN","23","18","41"
"6350","ESCUELA RAYEN LAFQUEN QUEULE","9118","TOLTEN","9","11","20"
"6351","ESCUELA EL SEMBRADOR","9118","TOLTEN","3","2","5"
"6352","ESCUELA AMANECER DE VILLA LOS BOLDOS","9118","TOLTEN","4","13","17"
"6397","LICEO MUNICIPAL BARROS ARANA","9117","TEODORO SCHMIDT","6","9","15"
"6398","ESCUELA NUEVA ALBORADA","9117","TEODORO SCHMIDT","22","20","42"
"6399","ESCUELA HORIZONTES","9117","TEODORO SCHMIDT","14","10","24"
"6452","LICEO REINO DE SUECIA","9116","SAAVEDRA","18","8","26"
"6454","ESCUELA BASICA COLLICO RANCO","9116","SAAVEDRA","5","5","10"
"6455","ESCUELA BASICA BARTOLO LLANCALEO","9116","SAAVEDRA","2","5","7"
"6456","ESCCUELA BASICA INALAFQUEN","9116","SAAVEDRA","3","1","4"
"6457","ESC. BASICA AUGUSTO WINTER TAPIA","9116","SAAVEDRA","7","8","15"
"6459","ESC. BASICA ANTONIO LADINO","9116","SAAVEDRA","3","5","8"
"6495","ESCUELA RUCA RAQUI","9116","SAAVEDRA","2","1","3"
"6497","COMPLEJO EDUCACIONAL CLAUDIO ARRAU LEON","9102","CARAHUE","6","16","22"
"6499","ROMILIO ADRIAZOLA","9102","CARAHUE","15","8","23"
"6500","ESCUELA DARIO SALAS DIAZ","9102","CARAHUE","37","29","66"
"6501","ESCUELA BASICA KIM RUKA","9102","CARAHUE","28","37","65"
"6502","ESCUELA BASICA NEHUENTUE","9102","CARAHUE","5","2","7"
"6504","ESCUELA TRANAPUENTE","9102","CARAHUE","6","8","14"
"6518","ESCUELA BASICA EL MANZANO","9102","CARAHUE","2","2","4"
"6528","ESCUELA BASICA BAJO YUPEHUE","9102","CARAHUE","5","5","10"
"6585","LICEO LUIS GONZALEZ VASQUEZ","9111","NUEVA IMPERIAL","19","18","37"
"6586","LICEO JAMES MUNDELL","9121","CHOLCHOL","16","25","41"
"6587","ESCUELA ALEJANDRO GOROSTIAGA","9111","NUEVA IMPERIAL","29","43","72"
"6588","ESCUELA REPUBLICA","9111","NUEVA IMPERIAL","13","7","20"
"6589","ESCUELA JUAN XXIII","9111","NUEVA IMPERIAL","18","13","31"
"6593","ESCUELA BASICA EL CRUCERO","9111","NUEVA IMPERIAL","3","3","6"
"6604","ESCUELA LOS CARRERA","9108","LAUTARO","20","18","38"
"6708","LICEO GREGORIO URRUTIA","9106","GALVARINO","4","3","7"
"6709","ESCUELA MUNICIPAL RIO QUILLEN","9106","GALVARINO","20","14","34"
"6710","ESCUELA BASICA DE LA PIEDRA","9106","GALVARINO","8","6","14"
"6711","ESCUELA BASICA MANIUCO","9106","GALVARINO","4","3","7"
"6712","ESCUELA SAN JUAN DE AILLINCO","9106","GALVARINO","8","7","15"
"6714","ESCUELA MUNICIPAL DE LLUQUENTUE","9106","GALVARINO","2","6","8"
"6716","ESC. BASICA QUETRE","9106","GALVARINO","3","2","5"
"6718","ESCUELA BASICA DE EL CAPRICHO","9106","GALVARINO","6","6","12"
"6721","ESCUELA REDUCCION PANGUECO","9106","GALVARINO","0","3","3"
"6725","ESCUELA DE HUAMPOMALLIN","9106","GALVARINO","4","4","8"
"6726","ESCUELA BASICA SANTA MARGARITA","9106","GALVARINO","2","3","5"
"6731","ESCUELA  BASICA PELANTARO","9106","GALVARINO","1","1","2"
"6732","ESC. BASICA FORTIN NIELOL","9106","GALVARINO","3","5","8"
"6739","ESCUELA MUNICIPAL  NILPE","9106","GALVARINO","2","1","3"
"6754","LICEO ARMANDO ROBLES RIVERA","14101","VALDIVIA","37","29","66"
"6759","ESCUELA CHILE","14101","VALDIVIA","18","35","53"
"6762","ESCUELA MEXICO","14101","VALDIVIA","70","0","70"
"6764","ESCUELA ESPANA","14101","VALDIVIA","24","35","59"
"6765","COLEGIO DEPORTIVO MUNICIPAL DE VALDIVIA","14101","VALDIVIA","6","8","14"
"6766","COLEGIO TENIENTE HERNAN MERINO CORREA","14101","VALDIVIA","33","47","80"
"6767","ESCUELA LEONARDO DA VINCI","14101","VALDIVIA","9","22","31"
"6770","COLEGIO DE MUSICA JUAN SEBASTIAN BACH","14101","VALDIVIA","15","23","38"
"6772","C.E.I.A. NARCISO GARCIA BARRIA","10101","PUERTO MONTT","5","4","9"
"6773","ESCUELA LAS ANIMAS","14101","VALDIVIA","12","16","28"
"6774","ESCUELA EL LAUREL","14101","VALDIVIA","18","18","36"
"6777","ESCUELA FEDOR M.DOSTOIEVSKI","14101","VALDIVIA","17","18","35"
"6780","ESCUELA FERNANDO SANTIVAN","14101","VALDIVIA","11","18","29"
"6781","ESCUELA ALEMANIA","14101","VALDIVIA","10","16","26"
"6785","ESCUELA ANGACHILLA","14101","VALDIVIA","8","16","24"
"6787","CENTRO EDUC.ADULTOS LUIS MOLL BRIONES","14101","VALDIVIA","4","19","23"
"6791","ESCUELA DE NIEBLA JUAN BOSCH","14101","VALDIVIA","18","16","34"
"6793","ESCUELA RURAL HUELLELHUE","14101","VALDIVIA","2","1","3"
"6797","ESCUELA RURAL CURINANCO","14101","VALDIVIA","3","2","5"
"6814","ESCUELA RURAL MISION DE ARIQUE","14101","VALDIVIA","0","4","4"
"6852","ESCUELA RURAL JOSE ARNOLDO BILBAO","14106","MARIQUINA","5","9","14"
"6853","LICEO POLITECNICO PESQUERO","14106","MARIQUINA","6","2","8"
"6876","ESCUELA FRAY BERNABE DE LUCERNA","14106","MARIQUINA","3","3","6"
"6886","ESCUELA VALLE DE MARIQUINA","14106","MARIQUINA","37","36","73"
"6898","ESCUELA FELIPE BARTHOU CORBEAUX","14103","LANCO","5","12","17"
"6899","LICEO   REPUBLICA DEL BRASIL","14103","LANCO","11","18","29"
"6903","ESCUELA RURAL PUQUINE BAJO","14103","LANCO","4","1","5"
"6916","ESCUELA ALBERTO CORDOVA LATORRE","14103","LANCO","10","22","32"
"6930","ESCUELA FRANCIA","14104","LOS LAGOS","30","20","50"
"6932","ESCUELA NEVADA","14104","LOS LAGOS","15","16","31"
"6933","ESCUELA RURAL FOLILCO","14104","LOS LAGOS","5","12","17"
"6934","ESCUELA NUEVA ESPANA","14104","LOS LAGOS","30","39","69"
"6935","ESCUELA RURAL ANTILHUE","14104","LOS LAGOS","4","3","7"
"6953","ESCUELA RURAL EL SALTO","14104","LOS LAGOS","5","7","12"
"6983","ESCUELA BASICA JOSE M. BALMACEDA F.","14202","FUTRONO","36","33","69"
"6984","ESCUELA RURAL NONTUELA","14202","FUTRONO","8","8","16"
"7003","ESCUELA RURAL CURRINE","14202","FUTRONO","6","8","14"
"7016","ESCUELA BASICA DE CORRAL","14102","CORRAL","27","32","59"
"7020","ESCUELA RURAL CARBONEROS","14102","CORRAL","2","5","7"
"7023","ESCUELA RURAL LA AGUADA","14102","CORRAL","7","13","20"
"7031","LICEO GABRIELA MISTRAL","14105","MAFIL","26","25","51"
"7049","CENTRO EDUCATIVO FERNANDO SANTIVAN","14108","PANGUIPULLI","19","12","31"
"7050","ESCUELA MARIA ALVARADO GARAY","14108","PANGUIPULLI","9","15","24"
"7059","ESCUELA MANUEL ANABALÓN SÁEZ","14108","PANGUIPULLI","18","26","44"
"7061","ESCUELA RURAL LA RINCONADA","14108","PANGUIPULLI","7","12","19"
"7062","ESCUELA RURAL PULLINQUE","14108","PANGUIPULLI","9","5","14"
"7063","ESCUELA RURAL HUELLAHUE","14108","PANGUIPULLI","10","7","17"
"7064","ESCUELA BASICA REPUBLICA DE CHILE","14108","PANGUIPULLI","5","5","10"
"7083","ESCUELA RURAL BOCATOMA","14108","PANGUIPULLI","3","2","5"
"7085","COMPLEJO EDUCACIONAL TIERRA DE ESPERANZA","14108","PANGUIPULLI","6","7","13"
"7086","ESCUELA RURAL COIHUECO","14108","PANGUIPULLI","0","4","4"
"7100","ESCUELA RURAL LLONQUEN","14108","PANGUIPULLI","2","9","11"
"7128","COLEGIO DE CULTURA Y DIFUSION ARTISTICA","14201","LA UNION","31","24","55"
"7129","LICEO RECTOR ABDON ANDRADE COLOMA","14201","LA UNION","34","22","56"
"7130","ESCUELA  LA UNION","14201","LA UNION","18","21","39"
"7131","ESCUELA PRESIDENTE JORGE ALESSANDRI R.","14201","LA UNION","26","23","49"
"7133","ESCUELA RADIMADI","14201","LA UNION","12","21","33"
"7135","COLEGIO TECNICO PROFESIONAL N°1 HONORIO OJEDA VALDERAS","14201","LA UNION","2","2","4"
"7136","ESCUELA RURAL CATAMUTUN","14201","LA UNION","5","7","12"
"7137","ESCUELA RURAL CHOROICO","14201","LA UNION","6","5","11"
"7138","ESCUELA RURAL PUERTO NUEVO","14201","LA UNION","7","8","15"
"7140","ESCUELA RURAL LOS ESTEROS","14201","LA UNION","5","10","15"
"7142","ESCUELA RURAL CUINCO","14201","LA UNION","1","3","4"
"7147","ESCUELA RURAL HUILLINCO","14201","LA UNION","1","5","6"
"7157","ESCUELA RURAL TRAIGUEN","14201","LA UNION","1","8","9"
"7168","ESCUELA RURAL LLANCACURA","14201","LA UNION","1","0","1"
"7170","ESCUELA RURAL MASHUE","14201","LA UNION","0","6","6"
"7202","ESCUELA PROYECTO DE FUTURO","14107","PAILLACO","36","49","85"
"7203","ESCUELA OLEGARIO MORALES OLIVA","14107","PAILLACO","20","27","47"
"7204","ESCUELA NUEVA AURORA","14107","PAILLACO","9","7","16"
"7205","ESCUELA ROBERTO OJEDA TORRES","14107","PAILLACO","5","0","5"
"7206","ESCUELA RURAL 21 DE MAYO","14107","PAILLACO","15","16","31"
"7237","ESCUELA BASICA RIO BUENO","14204","RIO BUENO","35","26","61"
"7238","ESCUELA BASICA PATRICIO LYNCH","14204","RIO BUENO","10","10","20"
"7240","ESCUELA RURAL CRUCERO","14204","RIO BUENO","19","18","37"
"7242","ESCUELA RURAL VIVANCO","14204","RIO BUENO","3","10","13"
"7243","ESCUELA RURAL CARIMALLIN BAJO","14204","RIO BUENO","7","9","16"
"7244","ESCUELA RURAL COLONIA DIUMEN","14204","RIO BUENO","7","9","16"
"7250","ESCUELA RURAL VALLE MANTILHUE BAJO","14204","RIO BUENO","4","0","4"
"7252","ESCUELA RURAL MANTILHUE ALTO","14204","RIO BUENO","4","4","8"
"7260","ESCUELA RURAL CHAMPULLI","14204","RIO BUENO","10","4","14"
"7261","ESCUELA RURAL CHIRRE","14204","RIO BUENO","2","1","3"
"7273","ESCUELA RURAL EL ARRAYAN","14204","RIO BUENO","3","6","9"
"7299","LICEO ANTONIO VARAS","14203","LAGO RANCO","23","28","51"
"7301","ESCUELA RURAL ILIHUE","14203","LAGO RANCO","3","3","6"
"7303","ESCUELA RURAL RININAHUE","14203","LAGO RANCO","10","8","18"
"7325","LICEO CARMELA CARVAJAL DE PRAT","10301","OSORNO","68","41","109"
"7332","ESCUELA JUAN RICARDO SANCHEZ ASCENCIO","10301","OSORNO","9","19","28"
"7333","ESCUELA ESPAÑA","10301","OSORNO","18","17","35"
"7334","ESCUELA EFRAIN CAMPANA SILVA","10301","OSORNO","22","36","58"
"7335","ESCUELA  SUIZA","10301","OSORNO","11","8","19"
"7336","ESCUELA FUNDACION PAUL HARRIS","10301","OSORNO","11","13","24"
"7337","ESCUELA GARCIA HURTADO DE MENDOZA","10301","OSORNO","16","17","33"
"7338","ESCUELA LEONILA FOLCH LOPEZ","10301","OSORNO","28","42","70"
"7339","ESCUELA N.88 CANADA","10301","OSORNO","34","31","65"
"7340","ESCUELA CLAUDIO ARRAU","10301","OSORNO","18","18","36"
"7341","ESCUELA MONSEÑOR FRANCISCO VALDES SUBERCASEAUX","10301","OSORNO","16","14","30"
"7343","ESCUELA MEXICO DE MICHOACAN","10301","OSORNO","58","47","105"
"7346","ESCUELA N. 46 ITALIA","10301","OSORNO","33","38","71"
"7347","ESCUELA LAGO RUPANCO","10301","OSORNO","5","7","12"
"7348","ESCUELA CARLOS CONDELL","10301","OSORNO","28","26","54"
"7349","ESCUELA DE ARTES Y CULTURA OSORNO","10301","OSORNO","14","8","22"
"7352","ESCUELA SOCIEDAD DE SOCORRO DE SEÑORAS","10301","OSORNO","18","11","29"
"7354","ESCUELA RURAL LUZ Y SABER","10301","OSORNO","3","10","13"
"7355","ESCUELA RURAL EMILIO SURBER SCHULZ","10301","OSORNO","1","4","5"
"7357","ESCUELA RURAL PUCOIHUE","10301","OSORNO","4","6","10"
"7369","ESCUELA RURAL PICHIL","10301","OSORNO","6","14","20"
"7372","ESCUELA RURAL CANCHA LARGA","10301","OSORNO","4","3","7"
"7377","ESCUELA RURAL WALTERIO MEYER RUSCA","10301","OSORNO","10","12","22"
"7382","ESCUELA RURAL LOS ABEDULES","10301","OSORNO","4","0","4"
"7384","ESCUELA RURAL TACAMO ALTO","10301","OSORNO","1","1","2"
"7418","ESCUELA BASICA SAN PABLO","10307","SAN PABLO","10","13","23"
"7419","ESCUELA DELICIO CARDENAS BUSTAMANTE","10307","SAN PABLO","4","8","12"
"7427","ESCUEAL RURAL QUILEN","10307","SAN PABLO","4","3","7"
"7431","ESCUELA RURAL TRUMAO","10307","SAN PABLO","1","4","5"
"7432","ESCUELA RURAL JULIO MOHR SCHULER","10307","SAN PABLO","5","5","10"
"7433","ESCUELA RURAL LA POZA","10307","SAN PABLO","1","1","2"
"7448","ESCUELA ENTRE LAGOS","10304","PUYEHUE","32","34","66"
"7449","ESCUELA RURAL ARMANDO SCHEUCH EPPLE","10304","PUYEHUE","8","5","13"
"7450","ESCUELA RURAL LOS PELLINES","10304","PUYEHUE","12","14","26"
"7452","ESCUELA RURAL EL ENCANTO","10304","PUYEHUE","3","6","9"
"7458","ESCUELA RURAL ÑADY","10304","PUYEHUE","1","3","4"
"7459","ESCUELA RURAL ESTACION NUEVO PORVENIR","10304","PUYEHUE","10","14","24"
"7460","ESCUELA RURAL PILMAIQUEN","10304","PUYEHUE","5","10","15"
"7471","ESCUELA RURAL PAJARITOS","10304","PUYEHUE","0","2","2"
"7476","ESCUELA ALBERTO HURTADO","10302","PUERTO OCTAY","12","16","28"
"7477","ESCUELA RURAL ADMINISTRACION RUPANCO","10302","PUERTO OCTAY","3","10","13"
"7478","ESCUELA RURAL LAS CASCADAS","10302","PUERTO OCTAY","10","12","22"
"7496","ESCUELA RURAL NOCHACO","10302","PUERTO OCTAY","6","11","17"
"7498","ESCUELA RURAL COIHUECO","10302","PUERTO OCTAY","2","1","3"
"7507","ESCUELA BERTOLDO HOFMANN KAHLER","10303","PURRANQUE","13","10","23"
"7508","ESCUELA VILLA LO BURGOS","10303","PURRANQUE","14","12","26"
"7509","CENTRO EDUCACION INTEGRAL DE ADULTOS","10303","PURRANQUE","12","9","21"
"7510","ESCUELA RURAL LA PAZ","10303","PURRANQUE","7","6","13"
"7511","ESCUELA RURAL ANTONIO SEGUNDO FERNANDEZ PORTALES","10303","PURRANQUE","1","2","3"
"7531","ESCUELA PURRANQUE","10303","PURRANQUE","4","6","10"
"7535","ESCUELA RURAL NUEVA ISRAEL","10303","PURRANQUE","2","4","6"
"7541","ESCUELA ANDREW JACKSON","10305","RIO NEGRO","22","35","57"
"7543","ESCUELA RIO NEGRO","10305","RIO NEGRO","12","23","35"
"7544","COLEGIO RIACHUELO","10305","RIO NEGRO","21","12","33"
"7583","ESCUELA RURAL PUAUCHO","10306","SAN JUAN DE LA COSTA","11","12","23"
"7593","ESCUELA RURAL BAHIA MANSA","10306","SAN JUAN DE LA COSTA","8","18","26"
"7624","ESCUELA DE ADULTOS RELONCAVI","10101","PUERTO MONTT","9","5","14"
"7627","LICEO DE HOMBRES MANUEL MONTT","10101","PUERTO MONTT","0","84","84"
"7628","LICEO ISIDORA ZEGERS DE HUNEEUS","10101","PUERTO MONTT","19","0","19"
"7630","ESCUELA ESPANA","10101","PUERTO MONTT","74","0","74"
"7631","ESCUELA N°2 REPUBLICA ARGENTINA","10101","PUERTO MONTT","34","43","77"
"7632","ESCUELA N 10 ANGELMO","10101","PUERTO MONTT","22","39","61"
"7633","ESCUELA CAPITAN ARTURO PRAT CHACON","10101","PUERTO MONTT","30","30","60"
"7634","ESCUELA MIRASOL","10101","PUERTO MONTT","30","43","73"
"7636","ESCUELA N 5 MIRAMAR","10101","PUERTO MONTT","17","14","31"
"7637","ESCUELA N 7 ARABE-SIRIA","10101","PUERTO MONTT","30","30","60"
"7638","ESCUELA N 3 MELIPULLI","10101","PUERTO MONTT","30","36","66"
"7639","COLEGIO DARIO SALAS","10101","PUERTO MONTT","33","31","64"
"7641","ESCUELA BELLAVISTA","10101","PUERTO MONTT","12","13","25"
"7642","ESCUELA LA COLINA","10101","PUERTO MONTT","13","11","24"
"7643","ESCUELA CHILOE","10101","PUERTO MONTT","17","27","44"
"7644","ESCUELA BASICA SANTA INES","10101","PUERTO MONTT","11","10","21"
"7646","ESCUELA ROTARIO PEDRO AVELINO BRAVO","10101","PUERTO MONTT","15","25","40"
"7647","ESCUELA LIBERTAD","10101","PUERTO MONTT","23","18","41"
"7648","ESCUELA MARCELA PAZ","10101","PUERTO MONTT","11","10","21"
"7650","ESCUELA DE CULTURA Y DIFUSION ARTISTICA","10101","PUERTO MONTT","11","7","18"
"7651","LICEO RURAL PIEDRA AZUL","10101","PUERTO MONTT","12","12","24"
"7654","ESCUELA RURAL LENCA","10101","PUERTO MONTT","9","13","22"
"7655","ESCUELA RURAL MAILLEN","10101","PUERTO MONTT","5","7","12"
"7656","ESCUELA RURAL PELLUCO","10101","PUERTO MONTT","2","5","7"
"7658","ESCUELA RURAL CORRENTOSO","10101","PUERTO MONTT","3","8","11"
"7659","ESCUELA ALERCE HISTORICO","10101","PUERTO MONTT","39","31","70"
"7664","ESCUELA CAYENEL","10101","PUERTO MONTT","10","12","22"
"7665","ESCUELA RURAL LA CHAMIZA","10101","PUERTO MONTT","8","11","19"
"7667","CENTRO DE EDUCACION DE ADULTOS JOSE BERNARDO SUAREZ","10101","PUERTO MONTT","6","11","17"
"7669","ESCUELA RURAL ILQUE","10101","PUERTO MONTT","1","7","8"
"7671","ESCUELA RURAL LAGUNITAS","10101","PUERTO MONTT","12","14","26"
"7672","ESCUEAL RURAL CHAICAS","10101","PUERTO MONTT","8","8","16"
"7675","ESCUELA RURAL TRAPEN","10101","PUERTO MONTT","11","9","20"
"7679","ESCUELA RURAL HUELMO","10101","PUERTO MONTT","8","14","22"
"7682","ESCUELA RURAL LA PALOMA","10101","PUERTO MONTT","3","4","7"
"7696","ESCUELA ANAHUAC","10101","PUERTO MONTT","9","15","24"
"7722","COLEGIO ROSITA NOVARO DE NOVARO PUERTO VARAS","10109","PUERTO VARAS","28","26","54"
"7723","ESCUELA GRUPO ESCOLAR","10109","PUERTO VARAS","25","19","44"
"7724","COLEGIO NUEVA BRAUNAU","10109","PUERTO VARAS","15","18","33"
"7725","ESCUELA RURAL COLONIA RIO SUR","10109","PUERTO VARAS","9","4","13"
"7726","ESCUELA RURAL SANTA MARIA","10109","PUERTO VARAS","1","3","4"
"7740","ESCUELA RURAL EPSON DE ENSENADA","10109","PUERTO VARAS","7","13","20"
"7741","ESCUELA RURAL RICARDO ROTH SCHUTZ","10109","PUERTO VARAS","1","1","2"
"7753","ESCUELA BASICA FRONTERIZA JUAN SOLER MANFREDINI","10103","COCHAMO","12","7","19"
"7760","ESCUELA RURAL RIO PUELO","10103","COCHAMO","11","5","16"
"7763","ESCUELA RURAL CAPITÀN DE BANDADA CARLOS RODRIGUEZ PARIS","10103","COCHAMO","2","6","8"
"7773","ESCUELA EULOGIO GOYCOLEA GARAY","10102","CALBUCO","24","17","41"
"7774","ESCUELA RURAL SAN RAFAEL","10102","CALBUCO","20","14","34"
"7775","ESCUELA RURAL PARGUA","10102","CALBUCO","15","15","30"
"7776","ESCUELA RURAL EL SEMBRADOR","10102","CALBUCO","4","3","7"
"7777","ESCUELA RURAL EL ROSARIO","10102","CALBUCO","9","9","18"
"7779","ESCUELA RURAL ESTERO HUITO","10102","CALBUCO","1","3","4"
"7782","ESCUELA RURAL QUEULLIN","10102","CALBUCO","3","1","4"
"7783","ESCUELA RURAL CHAUQUEAR","10102","CALBUCO","6","5","11"
"7785","ESCUELA RURAL QUETROLAUQUEN","10102","CALBUCO","2","6","8"
"7788","ESCUELA RURAL CHAYAHUE","10102","CALBUCO","8","9","17"
"7789","ESCUELA RURAL ALONSO DE ERCILLA","10102","CALBUCO","5","4","9"
"7791","ESCUELA RURAL AGUANTAO","10102","CALBUCO","3","4","7"
"7793","ESCUELA RURAL MARIO MORALES BECA","10102","CALBUCO","2","4","6"
"7798","ESCUELA RURAL EL DAO","10102","CALBUCO","3","7","10"
"7801","ESCUELA RURAL PUTENIO","10102","CALBUCO","7","4","11"
"7802","ESCUELA RURAL SAN JOSE","10102","CALBUCO","14","12","26"
"7804","ESCUELA RURAL LA POZA","10102","CALBUCO","1","0","1"
"7810","ESCUELA RURAL SAN ANTONIO","10102","CALBUCO","4","3","7"
"7818","ESCUELA RURAL PEÑASMO","10102","CALBUCO","9","7","16"
"7820","ESCUELA RURAL CHUCAGUA","10102","CALBUCO","0","4","4"
"7821","ESCUELA RURAL ISLA TABON","10102","CALBUCO","2","1","3"
"7825","ESCUELA LIBERTADOR GENERAL BERNARDO O´HIGGINS RIQUELME","10102","CALBUCO","5","14","19"
"7832","ESCUELA RURAL FRANCISCO CORTES OJEDA","10108","MAULLIN","5","9","14"
"7833","ESCUELA JOSE ABELARDO NUÑEZ","10108","MAULLIN","18","22","40"
"7834","ESCUELA ENCARNACION OLIVARES","10108","MAULLIN","15","13","28"
"7836","ESCUELA RURAL DORILA AGUILA AGUILAR","10108","MAULLIN","9","14","23"
"7850","ESCUELA RURAL LOS ARCES","10108","MAULLIN","4","13","17"
"7854","ESCUELA RURAL JUANITA GALLARDO","10108","MAULLIN","6","9","15"
"7866","ESCUELA RURAL HILDA HUNQUEN","10108","MAULLIN","7","4","11"
"7872","COLEGIO DE DIFUSION ARTISTICA LOS ULMOS","10106","LOS MUERMOS","10","18","28"
"7874","ESCUELA RURAL CAÑITAS","10106","LOS MUERMOS","7","8","15"
"7896","ESCUELA RURAL ESTAQUILLA","10106","LOS MUERMOS","3","5","8"
"7897","ESCUELA RURAL MANUEL GATICA ARRIAGADA","10106","LOS MUERMOS","2","5","7"
"7898","ESCUELA RURAL EL MELI","10106","LOS MUERMOS","7","8","15"
"7901","ESCUELA RURAL EL SARAOS","10106","LOS MUERMOS","0","1","1"
"7905","ESCUELA RURAL PARAGUAY CHICO","10106","LOS MUERMOS","4","4","8"
"7924","ESCUELA RURAL SAN ANDRES","10104","FRESIA","6","12","18"
"7929","ESCUELA BASICA AGRICOLA HUEMPELEO","10104","FRESIA","1","5","6"
"7940","ESCUELA RURAL PARGA","10104","FRESIA","1","3","4"
"7958","ESCUELA INES GALLARDO ALVARADO","10107","LLANQUIHUE","32","33","65"
"7959","ESCUELA BASICA GABRIELA MISTRAL","10107","LLANQUIHUE","29","29","58"
"7961","ESCUELA RURAL LOS PELLINES","10107","LLANQUIHUE","6","9","15"
"7962","ESCUELA RURAL LONCOTORO","10107","LLANQUIHUE","2","3","5"
"7967","ESCUELA RURAL COLEGUAL","10107","LLANQUIHUE","6","6","12"
"7975","ESCUELA ARTURO ALESSANDRI PALMA","10105","FRUTILLAR","21","15","36"
"7976","ESCUELA BERNARDO PHILIPPI","10105","FRUTILLAR","13","25","38"
"7977","ESCUELA RURAL LOS LINARES DE CASMA","10105","FRUTILLAR","17","15","32"
"7982","ESCUELA RURAL PARAGUAY","10105","FRUTILLAR","4","2","6"
"8002","LICEO GALVARINO RIVEROS CARDENAS","10201","CASTRO","38","33","71"
"8003","ESCUELA LUIS URIBE DIAZ","10201","CASTRO","36","39","75"
"8004","ESCUELA INES MUNOZ DE GARCIA","10201","CASTRO","35","41","76"
"8005","ESCUELA AYTUE","10201","CASTRO","54","62","116"
"8006","ESCUELA RURAL PEDRO VELAZQUEZ BONTES","10201","CASTRO","9","21","30"
"8013","ESCUELA RURAL MIRTA OYARZO VERA","10201","CASTRO","6","7","13"
"8019","ESCUELA RURAL QUILQUICO","10201","CASTRO","2","7","9"
"8022","ESCUELA RURAL ERMELINDA SANCHEZ DE CIFUENTES","10201","CASTRO","2","3","5"
"8027","ESCUELA RURAL OLINDA BORQUEZ BORQUEZ","10201","CASTRO","3","12","15"
"8036","ESCUELA RURAL LOS ANGELES","10201","CASTRO","4","6","10"
"8037","ESCUELA RURAL LOS ROBLES","10201","CASTRO","4","2","6"
"8046","ESCUELA PUDETO","10202","ANCUD","12","7","19"
"8047","ESCUELA ANEXA","10202","ANCUD","27","18","45"
"8048","ESCUELA YERBAS BUENAS","10202","ANCUD","8","6","14"
"8049","ESCUELA RURAL VILLA CHACAO","10202","ANCUD","2","7","9"
"8050","ESCUELA FATIMA","10202","ANCUD","4","8","12"
"8051","ESCUELA RURAL EL PALOMAR","10202","ANCUD","10","11","21"
"8053","ESCUELA RURAL SENDA CHACAO","10202","ANCUD","4","8","12"
"8054","ESCUELA RURAL MANAO","10202","ANCUD","7","6","13"
"8085","ESCUELA RURAL SAN MIGUEL DE COÑIMO","10202","ANCUD","5","9","14"
"8092","ESCUELA RURAL LUIS ALBERTO SEGOVIA ROSS","10202","ANCUD","5","5","10"
"8100","ESCUELA RURAL SOL DEL PACIFICO","10202","ANCUD","10","11","21"
"8103","ESCUELA RURAL BAHIA LINAO","10202","ANCUD","5","4","9"
"8105","LICEO BICENTENARIO DE ANCUD","10202","ANCUD","25","27","52"
"8112","ESCUELA RURAL JUAN VICTORINO TANGOL","10205","DALCAHUE","0","6","6"
"8113","ESCUELA RURAL AQUELARRE","10209","QUEMCHI","7","11","18"
"8114","ESCUELA RURAL LLIUCO","10209","QUEMCHI","7","7","14"
"8117","ESCUELA RURAL MONTEMAR","10209","QUEMCHI","7","10","17"
"8133","ESCUELA RURAL LINDA VISTA","10209","QUEMCHI","2","4","6"
"8142","ESCUELA RURAL BORDEMAR VILLA MECHUQUE","10209","QUEMCHI","1","1","2"
"8144","ESCUELA RURAL CESAR GOMEZ GARCIA","10205","DALCAHUE","1","7","8"
"8147","ESCUELA RURAL MALLINLEMU","10205","DALCAHUE","13","13","26"
"8158","ESCUELA RURAL CALEN","10205","DALCAHUE","3","3","6"
"8159","ESCUELA RURAL JOSE DANIEL BAHAMONDE BAHAMONDE","10205","DALCAHUE","5","6","11"
"8161","ESCUELA BASICA DALCAHUE","10205","DALCAHUE","23","34","57"
"8162","LICEO ALFREDO DEL CARMEN BARRIA OYARZUN","10204","CURACO DE VELEZ","10","15","25"
"8165","ESCUELA RURAL EDUARDO FREI MONTALVA","10204","CURACO DE VELEZ","2","2","4"
"8169","ESCUELA RURAL HUYAR ALTO","10204","CURACO DE VELEZ","3","2","5"
"8174","LICEO INSULAR","10210","QUINCHAO","31","20","51"
"8176","ESCUELA RURAL LA CAPILLA","10210","QUINCHAO","4","4","8"
"8177","ESCUELA RURAL OSTRICULTURA","10210","QUINCHAO","5","5","10"
"8180","ESCUELA RURAL ALAO","10210","QUINCHAO","2","2","4"
"8182","ESCUELA RURAL LA VILLA","10210","QUINCHAO","1","1","2"
"8183","ESCUELA RURAL AMANECER 2000","10210","QUINCHAO","2","0","2"
"8186","ESCUELA RURAL LOS PINOS","10210","QUINCHAO","5","4","9"
"8188","ESCUELA RURAL LA CAPILLA","10210","QUINCHAO","0","3","3"
"8189","ESCUELA RURAL TERESA CARDENAS DE PAREDES","10210","QUINCHAO","14","6","20"
"8191","ESCUELA RURAL SAN FRANCISCO","10210","QUINCHAO","7","3","10"
"8195","ESCUELA PUQUELDON","10206","PUQUELDON","6","7","13"
"8201","ESCUELA RURAL LAS CAMPANAS","10206","PUQUELDON","4","2","6"
"8202","ESCUELA RURAL DETIF","10206","PUQUELDON","4","3","7"
"8203","ESCUELA RURAL SANTA ROSA","10206","PUQUELDON","6","2","8"
"8205","ESCUELA RURAL ICHUAC","10206","PUQUELDON","3","2","5"
"8206","LICEO MANUEL JESUS ANDRADE BORQUEZ","10203","CHONCHI","26","23","49"
"8207","ESCUELA RURAL NOTUCO","10203","CHONCHI","1","2","3"
"8208","ESCUELA RURAL CURACO DE VILUPULLI","10203","CHONCHI","0","1","1"
"8210","ESCUELA RURAL QUITRIPULLI","10203","CHONCHI","8","2","10"
"8211","ESCUELA RURAL HUILLINCO","10203","CHONCHI","7","8","15"
"8220","ESCUELA RURAL CUCAO","10203","CHONCHI","1","3","4"
"8230","ESCUELA RURAL RAUCO","10203","CHONCHI","4","1","5"
"8231","ESCUELA RURAL TERAO","10203","CHONCHI","0","4","4"
"8236","ESCUELA CHILHUE","10207","QUEILEN","20","18","38"
"8241","ESCUELA RURAL ALVARO VARGAS MIRANDA","10207","QUEILEN","10","8","18"
"8247","ESCUELA RURAL JUAN ANTONIO VERA DIAZ","10207","QUEILEN","9","7","16"
"8256","ESCUELA EDUCADORA EULOGIA BORQUEZ PEREZ","10208","QUELLON","31","30","61"
"8263","ESCUELA RURAL JOSE SANTOS LINCOMAN INAICHEO","10208","QUELLON","1","1","2"
"8264","ESCUELA RURAL ADELA GARCIA GARCIA","10208","QUELLON","8","4","12"
"8269","ESCUELA RURAL LASTENIA OYARZUN ANDRADE","10208","QUELLON","1","2","3"
"8278","ESCUELA RURAL YELCHO","10208","QUELLON","3","1","4"
"8284","ESCUELA RURAL COINCO","10208","QUELLON","5","2","7"
"8287","ESCUELA RURAL AUCHAC","10208","QUELLON","0","1","1"
"8288","ESCUELA RURAL YALDAD","10208","QUELLON","1","2","3"
"8289","ESCUELA RURAL ARTISTICA ALUMNO MARCELO GUENTEO SOLIS","10208","QUELLON","13","11","24"
"8295","ESCUELA RURAL CHUIT","10401","CHAITEN","1","3","4"
"8296","ESCUELA RURAL NUEVA ESPERANZA","10401","CHAITEN","1","0","1"
"8301","ESCUELA RURAL BUILL","10401","CHAITEN","1","3","4"
"8303","ESCUELA RURAL CHUMELDEN","10401","CHAITEN","3","1","4"
"8306","ESCUELA RURAL VALLE EL FRIO","10401","CHAITEN","2","2","4"
"8309","ESCUELA RURAL AYACARA","10401","CHAITEN","4","9","13"
"8310","COLEGIO MAURICIO HITCHCOCK","10403","HUALAIHUE","14","11","25"
"8311","ESCUELA RURAL AULEN","10403","HUALAIHUE","7","7","14"
"8313","ESCUELA RURAL CATARATAS DEL ALERCE","10403","HUALAIHUE","9","5","14"
"8321","ESCUELA RURAL CALETA EL MANZANO","10403","HUALAIHUE","4","12","16"
"8323","ESCUELA RURAL N.745 SEMILLERO","10403","HUALAIHUE","8","8","16"
"8325","ESCUELA ANTUPIREN","10403","HUALAIHUE","29","27","56"
"8331","ESCUELA FUTALEUFU","10402","FUTALEUFU","13","14","27"
"8339","ESCUELA ROBERTO WHITE GESELL","10404","PALENA","9","7","16"
"8341","ESCUELA RURAL FRONTERIZA","10404","PALENA","0","1","1"
"8346","ESCUELA VICTOR DOMINGO SILVA","11101","COIHAIQUE","18","18","36"
"8348","ESCUELA BAQUEDANO","11101","COIHAIQUE","17","24","41"
"8349","ESCUELA PEDRO QUINTANA MANSILA","11101","COIHAIQUE","25","27","52"
"8352","LICEO REPUBLICA ARGENTINA","11101","COIHAIQUE","9","26","35"
"8353","ESCUELA NIEVES DEL SUR","11101","COIHAIQUE","9","11","20"
"8355","ESCUELA RURAL PABLO NERUDA","11101","COIHAIQUE","3","2","5"
"8356","ESCUELA RURAL CON INTERNADO RIO BLANCO","11101","COIHAIQUE","1","4","5"
"8357","ESCUELA RURAL VALLE SIMPSON","11101","COIHAIQUE","6","6","12"
"8358","ESCUELA JOSE ANTOLIN SILVA ORMENO","11101","COIHAIQUE","3","0","3"
"8361","ESCUELA RURAL VALLE DE LA LUNA","11101","COIHAIQUE","2","0","2"
"8370","ESCUELA MUNICIPAL VILLA AMENGUAL","11102","LAGO VERDE","3","2","5"
"8371","ESC.CON INTERNADO JOSE MIGUEL CARRERA","11102","LAGO VERDE","2","4","6"
"8372","ESCUELA RURAL CON INTERNADO LA TAPERA","11102","LAGO VERDE","1","2","3"
"8375","LICEO POLITECNICO DE AYSEN","11201","AISEN","15","30","45"
"8376","ESCUELA BASICA","11201","AISEN","13","8","21"
"8379","ESCUELA PEDRO AGUIRRE CERDA","11201","AISEN","3","3","6"
"8380","LICEO MANIHUALES","11201","AISEN","15","14","29"
"8382","ESCUELA CARLOS CONDELL","11201","AISEN","0","7","7"
"8384","ESCUELA ALMIRANTE SIMPSON","11201","AISEN","6","5","11"
"8388","ESCUELA GUIDO GOMEZ MUNOZ","11202","CISNES","21","8","29"
"8389","ESCUELA AMANDA LABARCA HUBERSTONE","11202","CISNES","6","2","8"
"8390","ESCUELA HAMBURGO","11202","CISNES","5","5","10"
"8391","ESCUELA EUSEBIO IBAR SCHEPELER","11202","CISNES","11","9","20"
"8392","LICEO MELINKA","11203","GUAITECAS","16","13","29"
"8394","LICEO LUISA RABANAL DE PALMA","11401","CHILE CHICO","22","28","50"
"8398","ESC. LIBERTADOR BERNARDO O´HIGGINS RIQUELME","11401","CHILE CHICO","6","6","12"
"8401","ESCUELA GABRIELA MISTRAL","11402","RIO IBAÑEZ","3","3","6"
"8403","LICEO RURAL CERRO CASTILLO","11402","RIO IBAÑEZ","5","7","12"
"8404","ESCUELA AONIKENK","11402","RIO IBAÑEZ","8","6","14"
"8405","ESCUELA RURAL CARRETERA AUSTRAL","11402","RIO IBAÑEZ","0","2","2"
"8408","ESC.  BASICA  HERNAN MERINO CORREA","11301","COCHRANE","25","23","48"
"8409","ESCUELA PIONEROS DEL SUR","11302","O'HIGGINS","3","7","10"
"8410","ESCUELA MUNICIPAL CDTE LUIS BRAVO BRAVO","11303","TORTEL","2","3","5"
"8412","ESCUELA LIB. BERNARDO O´HIGGINS R.","12401","NATALES","22","30","52"
"8413","ESCUELA CORONEL SANTIAGO BUERAS","12401","NATALES","11","16","27"
"8415","ESCUELA CAPITAN JUAN LADRILLERO","12401","NATALES","19","20","39"
"8417","ESCUELA BAUDILIA AVENDANO DE YOUSSUF","12401","NATALES","11","9","20"
"8419","ESC. PROF. MIGUEL S. MONTECINOS C.","12401","NATALES","1","1","2"
"8423","ESC.HOGAR MUN.FRONTERIZA RAMON SERRANO M","12402","TORRES DEL PAINE","2","2","4"
"8424","INSTIT.SUPERIOR DE COMERCIO JOSE MENENDEZ","12101","PUNTA ARENAS","18","18","36"
"8429","LICEO LUIS ALBERTO BARRERA","12101","PUNTA ARENAS","6","3","9"
"8432","CENTRO DE EDUC.INTEGRAL DE ADULTOS CEIA.","12101","PUNTA ARENAS","17","20","37"
"8433","ESCUELA LIBERTADOR CAP GRAL BDO OHIGGINS","12101","PUNTA ARENAS","30","28","58"
"8434","ESCUELA ESPANA","12101","PUNTA ARENAS","10","14","24"
"8435","ESCUELA DIECIOCHO DE SEPTIEMBRE","12101","PUNTA ARENAS","24","23","47"
"8436","ESCUELA PORTUGAL","12101","PUNTA ARENAS","24","31","55"
"8437","ESC. CAPITAN ARTURO PRAT CHACON","12101","PUNTA ARENAS","6","19","25"
"8438","ESCUELA REPUBLICA DE CROACIA","12101","PUNTA ARENAS","19","24","43"
"8439","ESCUELA JUAN WILLIAMS","12101","PUNTA ARENAS","34","24","58"
"8441","ESCUELA HERNANDO DE MAGALLANES","12101","PUNTA ARENAS","24","30","54"
"8442","ESCUELA PEDRO PABLO LEMAITRE","12101","PUNTA ARENAS","32","38","70"
"8444","ESCUELA PATAGONIA","12101","PUNTA ARENAS","33","31","64"
"8448","ESCUELA PEDRO SARMIENTO DE GAMBOA","12101","PUNTA ARENAS","11","11","22"
"8449","ESCUELA ELBA OJEDA GOMEZ","12101","PUNTA ARENAS","6","10","16"
"8452","ESCUELA DE PUERTO HARRIS","12101","PUNTA ARENAS","2","0","2"
"8468","ESCUELA DIEGO PORTALES","12102","LAGUNA BLANCA","5","5","10"
"8470","ESCUELA PUNTA DELGADA","12104","SAN GREGORIO","4","1","5"
"8475","ESCUELA LIBERTADOR BDO. O´HIGGINS R.","12301","PORVENIR","20","32","52"
"8479","ESCUELA CERRO SOMBRERO","12302","PRIMAVERA","5","4","9"
"8483","LICEO DONALD MC-INTYRE GRIFFITHS","12201","CABO DE HORNOS","15","23","38"
"8484","ESCUELA PUERTO TORO","12201","CABO DE HORNOS","0","1","1"
"8485","LICEO INSTITUTO NACIONAL","13101","SANTIAGO","0","726","726"
"8487","LICEO JAVIERA CARRERA","13101","SANTIAGO","469","0","469"
"8488","LICEO ISAURA DINATOR DE GUZMAN","13101","SANTIAGO","20","0","20"
"8489","LICEO BICENTENARIO TERESA PRATS","13101","SANTIAGO","35","0","35"
"8490","LICEO NRO 2 MIGUEL LUIS AMUNATEGUI","13101","SANTIAGO","5","16","21"
"8491","LICEO DE APLICACION RECTOR JORGE E SCHNE","13101","SANTIAGO","4","203","207"
"8497","LICEO GABRIELA MISTRAL","13108","INDEPENDENCIA","22","28","50"
"8498","LICEO DARIO SALAS","13101","SANTIAGO","4","8","12"
"8499","INTERNADO NACIONAL BARROS ARANA","13101","SANTIAGO","0","144","144"
"8503","INST.SUP.DE COMERCIO EDUARDO FREI M.","13101","SANTIAGO","27","21","48"
"8511","LICEO EXPERIMENTAL ARTISTICO B-65","13119","MAIPU","30","23","53"
"8513","ESC. BAS. REPUBLICA ORIENTAL DE URUGUAY","13101","SANTIAGO","25","31","56"
"8514","LICEO ROSA ESTER ALESANDRI RODRIGUEZ","13108","INDEPENDENCIA","76","0","76"
"8515","ESCUELA BASICA CORNELIA OLIVARES","13108","INDEPENDENCIA","16","19","35"
"8518","LICEO ESTACION CENTRAL","13106","ESTACION CENTRAL","14","23","37"
"8519","ESCUELA BASICA PEDRO AGUIRRE CERDA","13102","CERRILLOS","6","10","16"
"8520","ESCUELA BASICA PROVINCIA DE CHILOE","13101","SANTIAGO","18","32","50"
"8521","ESCUELA CARLOS CONDELL DE LA HAZA","13106","ESTACION CENTRAL","30","38","68"
"8522","ESCUELA BASICA REPUBLICA DE COLOMBIA","13101","SANTIAGO","34","34","68"
"8523","ESCUELA BASICA REPUBLICA DE PANAMA","13101","SANTIAGO","12","21","33"
"8530","ESCUELA CADETE ARTURO PRAT CHACON","13101","SANTIAGO","26","48","74"
"8531","ESCUELA BASICA IRENE FREI DE CID","13101","SANTIAGO","23","39","62"
"8532","ESCUELA BASICA LIBERTADORES DE CHILE","13101","SANTIAGO","18","12","30"
"8533","ESCUELA BASICA BENJAMIN VICUNA MACKENNA","13101","SANTIAGO","56","0","56"
"8535","LICEO REPUBLICA DE BRASIL","13101","SANTIAGO","14","20","34"
"8536","ESCUELA REPUBLICA DE ISRAEL","13101","SANTIAGO","23","18","41"
"8537","ESCUELA ARNALDO FALABELLA","13106","ESTACION CENTRAL","30","27","57"
"8540","ESCUELA BASICA REPUBLICA DE HAITI","13101","SANTIAGO","12","12","24"
"8542","LICEO SAN FRANCISCO DE QUITO","13108","INDEPENDENCIA","0","45","45"
"8544","ESCUELA BÁSICA ARTURO ALESSANDRI PALMA","13106","ESTACION CENTRAL","65","0","65"
"8546","ESC.BAS.BILINGUE REPUBLICA DEL PARAGUAY","13127","RECOLETA","79","93","172"
"8547","ESCUELA NUEVA ZELANDIA","13108","INDEPENDENCIA","9","17","26"
"8548","ESCUELA BASICA DR LUIS CALVO MACKENNA","13101","SANTIAGO","27","43","70"
"8549","ESCUELA FERNANDO ALESSANDRI RODRIGUEZ","13101","SANTIAGO","17","22","39"
"8552","ESCUELA BAS SALVADOR SANFUENTES REP EEUU","13101","SANTIAGO","0","61","61"
"8553","ESCUELA DE ADULTOS  JORGE ALESSANDRI R.","13127","RECOLETA","32","40","72"
"8554","LICEO MUNICIPAL METROPOLITANO DE ADULTOS","13101","SANTIAGO","17","25","42"
"8555","ESCUELA REPUBLICA EL LIBANO","13101","SANTIAGO","3","16","19"
"8556","ESCUELA REPUBLICA DE AUSTRIA","13106","ESTACION CENTRAL","14","26","40"
"8558","ESCUELA BÁSICA HUMBERTO VALENZUELA GARCÍA","13106","ESTACION CENTRAL","7","11","18"
"8561","ESCUELA REPUBLICA DE ALEMANIA","13101","SANTIAGO","11","23","34"
"8562","CIUDAD SANTIAGO DE CHILE","13101","SANTIAGO","11","16","27"
"8563","ESCUELA BASICA REPUBLICA DE MEXICO","13101","SANTIAGO","17","42","59"
"8564","ESCUELA BASICA REINO DE NORUEGA","13126","QUINTA NORMAL","10","22","32"
"8569","ESCUELA BASICA REPUBLICA DEL ECUADOR","13101","SANTIAGO","48","1","49"
"8572","ESCUELA BASICA CAMILO MORI","13108","INDEPENDENCIA","17","23","40"
"8576","ESCUELA BASICA REYES CATOLICOS","13101","SANTIAGO","9","13","22"
"8579","ESCUELA BASICA UNION LATINOAMERICANA","13106","ESTACION CENTRAL","13","21","34"
"8581","ESCUELA BÁSICA F Nº 64","13101","SANTIAGO","11","16","27"
"8587","LICEO DE ADULTOS ESTACION CENTRAL","13106","ESTACION CENTRAL","22","10","32"
"8815","COLEGIO SAN FRANCISCO DEL ALBA","13114","LAS CONDES","35","44","79"
"8821","LICEO MUNICIPALIZADO AMANDA LABARCA","13132","VITACURA","51","44","95"
"8822","LICEO JUAN PABLO II DE LAS CONDES","13114","LAS CONDES","29","28","57"
"8825","COLEGIO ANTARTICA CHILENA","13132","VITACURA","31","30","61"
"8828","LICEO SIMON BOLIVAR","13114","LAS CONDES","31","52","83"
"8835","LICEO SANTA MARIA DE LAS CONDES","13114","LAS CONDES","30","29","59"
"8839","INSTITUTO FERMIN VIVACETA","13115","LO BARNECHEA","15","16","31"
"8840","ESCUELA DE FARELLONES","13115","LO BARNECHEA","3","4","7"
"8925","LICEO POLIVALENTE ARTURO ALESSANDRI P.","13123","PROVIDENCIA","0","36","36"
"8926","LICEO DE NIÑAS N 7 LUISA SAAVEDRA DE GONZALEZ","13123","PROVIDENCIA","164","0","164"
"8927","LICEO CARMELA CARVAJAL DE PRAT","13123","PROVIDENCIA","254","0","254"
"8928","LICEO JOSE VICTORINO LASTARRIA","13123","PROVIDENCIA","0","153","153"
"8930","LICEO B 42 TAJAMAR","13123","PROVIDENCIA","62","1","63"
"8931","ESCUELA BASICA EL VERGEL","13123","PROVIDENCIA","55","1","56"
"8933","ESCUELA DE PROVIDENCIA","13123","PROVIDENCIA","54","53","107"
"9006","COMPLEJO EDUCACIONAL LA REINA","13113","LA REINA","14","11","25"
"9007","LICEO EUGENIO MARÍA DE HOSTOS","13113","LA REINA","11","12","23"
"9008","COLEGIO MUNICIPALIZADO CONFEDERAC SUIZA","13113","LA REINA","23","37","60"
"9011","COLEGIO SAN CONSTANTINO","13113","LA REINA","15","13","28"
"9012","ESCUELA BASICA YANGTSE EX E-229","13113","LA REINA","30","32","62"
"9013","ESCUELA PALESTINA","13113","LA REINA","26","32","58"
"9070","ESCUELA BENJAMIN CLARO VELASCO","13120","ÑUÑOA","27","17","44"
"9071","LICEO AUGUSTO D HALMAR","13120","ÑUÑOA","87","70","157"
"9072","LICEO VILLA MACUL ACADEMIA EX LICEO JUANA DE IBARBOUROU A 48","13118","MACUL","20","35","55"
"9073","LICEO CARMELA SILVA DONOSO","13120","ÑUÑOA","50","0","50"
"9074","LICEO JOSE TORIBIO MEDINA","13120","ÑUÑOA","46","54","100"
"9077","COMPLEJO EDUC.MUN. BRIGIDA  WALKER.","13120","ÑUÑOA","1","11","12"
"9078","LICEO LENKA FRANULIC","13120","ÑUÑOA","37","30","67"
"9085","ESCUELA JOSE BERNARDO SUAREZ","13118","MACUL","13","20","33"
"9087","CENTRO EDUC. VALLE HERMOSO","13122","PEÑALOLEN","21","16","37"
"9088","LICEO ANTONIO HERMIDA FABRES","13122","PEÑALOLEN","58","31","89"
"9089","ESCUELA BÁSICA JOSÉ TORIBIO MEDINA","13120","ÑUÑOA","19","25","44"
"9090","ESCUELA BAS. CENTRO EDUCACIONAL MILLANTU","13118","MACUL","8","11","19"
"9091","ESCUELA REPUBLICA DE FRANCIA","13120","ÑUÑOA","11","14","25"
"9097","ESCUELA REPUBLICA DE COSTA RICA","13120","ÑUÑOA","10","19","29"
"9098","ESCUELA JUAN BAUTISTA PASTEN","13122","PEÑALOLEN","20","33","53"
"9100","LICEO REPUBLICA DE SIRIA","13120","ÑUÑOA","69","63","132"
"9102","ESCUELA GUILLERMO ZANARTU IRIGOYEN","13120","ÑUÑOA","17","25","42"
"9103","ESCUELA UNION NACIONAL ARABE","13122","PEÑALOLEN","15","26","41"
"9105","CENTRO EDUCACIONAL EDUARDO DE LA BARRA","13122","PEÑALOLEN","23","27","50"
"9106","CENTRO EDUCACION MARIANO EGANA","13122","PEÑALOLEN","20","22","42"
"9110","ESCUELA CARLOS HERNANDEZ PENA","13122","PEÑALOLEN","18","18","36"
"9111","ESCUELA LUIS  ARRIETA CANAS","13122","PEÑALOLEN","8","12","20"
"9116","LICEO MUNICIPALIZADO MANUEL ROJAS","13118","MACUL","3","8","11"
"9117","ESCUELA E-180 MATILDE HUICI NAVAS","13122","PEÑALOLEN","25","30","55"
"9121","ESCUELA TOBALABA","13122","PEÑALOLEN","26","27","53"
"9122","ESCUELA JULIO MONTT SALAMANCA","13118","MACUL","21","29","50"
"9125","ESCUELA BASICA","13118","MACUL","21","19","40"
"9127","COLEGIO LIKANKURA DE PEÑALOLÉN","13122","PEÑALOLEN","38","34","72"
"9131","ESCUELA JUAN MOYA MORALES","13120","ÑUÑOA","23","30","53"
"9282","ESCUELA GUARDIAMARINA ERNESTO RIQUELME","13110","LA FLORIDA","17","14","31"
"9283","ESCUELA BELLAVISTA","13110","LA FLORIDA","63","75","138"
"9284","ESCUELA ELSA SANTIBANEZ","13110","LA FLORIDA","31","42","73"
"9285","ESCUELA MARCELA PAZ","13110","LA FLORIDA","13","13","26"
"9288","LICEO NUEVO AMANECER","13110","LA FLORIDA","17","13","30"
"9289","ESCUELA LAS ARAUCARIAS","13110","LA FLORIDA","16","17","33"
"9290","ESCUELA SOTERO DEL RIO","13110","LA FLORIDA","9","13","22"
"9292","COMPLEJO EDUC. MUNICIPAL CARDEN.A.SAMORE","13110","LA FLORIDA","8","16","24"
"9293","LICEO POLIVALENTE LOS ALMENDROS","13110","LA FLORIDA","12","17","29"
"9294","LICEO ANDRES BELLO","13110","LA FLORIDA","10","14","24"
"9296","ESCUELA LAS LILAS","13110","LA FLORIDA","12","11","23"
"9298","LICEO INDIRA GANDHI","13110","LA FLORIDA","28","36","64"
"9299","ESCUELA SANTA IRENE","13110","LA FLORIDA","29","32","61"
"9302","ESCUELA LO CANAS","13110","LA FLORIDA","10","20","30"
"9304","ESCUELA LOS CEREZOS","13110","LA FLORIDA","11","15","26"
"9306","ESCUELA LOS QUILLAYES","13110","LA FLORIDA","4","10","14"
"9307","ESCUELA  OSCAR CASTRO","13110","LA FLORIDA","19","27","46"
"9405","LICEO BETSABE HORMAZABAL DE ALARCON","13130","SAN MIGUEL","7","3","10"
"9406","LICEO ANDRES BELLO","13130","SAN MIGUEL","0","72","72"
"9410","ESCUELA  CONSOLIDADA DAVILA","13121","PEDRO AGUIRRE CERDA","6","8","14"
"9411","CENTRO EDUCACIONAL HORACIO ARAVENA A.","13129","SAN JOAQUIN","14","22","36"
"9413","ESCUELA GENERAL BASICA SANTA FE","13130","SAN MIGUEL","16","18","34"
"9414","COLEGIO CIUDAD DE FRANKFORT","13129","SAN JOAQUIN","10","19","29"
"9415","ESCUELA TERRITORIO ANTARTICO","13130","SAN MIGUEL","19","22","41"
"9416","ESCUELA POETAS DE CHILE","13121","PEDRO AGUIRRE CERDA","13","12","25"
"9418","ESCUELA LA VICTORIA","13121","PEDRO AGUIRRE CERDA","20","17","37"
"9419","LICEO MUNICIPAL ENRIQUE BACKAUSSE","13121","PEDRO AGUIRRE CERDA","5","7","12"
"9421","LICEO MUNICIPAL SAN JOAQUIN","13129","SAN JOAQUIN","6","14","20"
"9422","ESCUELA CENTRO EDUC. REP. MEXICANA","13121","PEDRO AGUIRRE CERDA","12","7","19"
"9424","ESCUELA BASICA FRAY CAMILO HENRIQUEZ","13129","SAN JOAQUIN","26","37","63"
"9426","ESCUELA LLANO SUBERCASEAUX","13130","SAN MIGUEL","22","30","52"
"9428","ESCUELA BASICA RICARDO E. LATCHMAN","13121","PEDRO AGUIRRE CERDA","12","7","19"
"9429","ESCUELA POETA VICTOR DOMINGO SILVA","13129","SAN JOAQUIN","10","10","20"
"9430","CENTRO EDUC. PROVINCIA DE ÑUBLE","13129","SAN JOAQUIN","11","24","35"
"9431","ESCUELA VILLA SAN MIGUEL","13130","SAN MIGUEL","20","15","35"
"9433","ESCUELA BASICA MUNICIPAL","13130","SAN MIGUEL","20","19","39"
"9437","ESC. BAS. Y ESP. SU SANTIDAD JUAN XXIII","13129","SAN JOAQUIN","10","8","18"
"9443","ESCUELA BAS. LOS HEROES DE YUNGAY","13111","LA GRANJA","11","14","25"
"9457","ESCUELA BÁSICA POETA NERUDA (EX-483)","13129","SAN JOAQUIN","10","14","24"
"9458","ESCUELA BOROA","13121","PEDRO AGUIRRE CERDA","17","16","33"
"9585","LICEO DOCTOR ALEJANDRO DEL RIO","13111","LA GRANJA","9","13","22"
"9586","LICEO MUNICIPALIZADO ARAUCANIA","13131","SAN RAMON","14","20","34"
"9587","LICEO MALAQUIAS CONCHA","13111","LA GRANJA","21","22","43"
"9588","ESCUELA BAS. TECNO SUR","13111","LA GRANJA","12","12","24"
"9590","ESCUELA BELGICA","13111","LA GRANJA","2","13","15"
"9591","LICEO N523","13112","LA PINTANA","11","21","32"
"9592","ESCUELA BASICA SENDERO DEL SABER","13131","SAN RAMON","17","13","30"
"9593","ESCUELA BASICA EDUCADORES DE CHILE","13131","SAN RAMON","5","16","21"
"9595","ESCUELA CAPITAN AVALOS","13112","LA PINTANA","17","28","45"
"9597","ESCUELA PABLO DE ROKHA","13112","LA PINTANA","12","21","33"
"9598","ESCUELA MUNICIPAL VIOLETA PARRA","13112","LA PINTANA","18","24","42"
"9599","LICEO MUNICIPAL PURKUYEN","13131","SAN RAMON","15","20","35"
"9600","ESCUELA NANIHUE","13131","SAN RAMON","18","15","33"
"9602","COLEGIO NERUDA","13112","LA PINTANA","18","15","33"
"9604","LICEO MUNICIPALIZADO CENT.ED. LA PINTANA","13112","LA PINTANA","38","32","70"
"9605","COLEGIO MUNICIPAL PROCERES DE CHILE","13111","LA GRANJA","11","14","25"
"9606","ESCUELA BAS. LA ARAUCANIA","13111","LA GRANJA","13","12","25"
"9609","ESCUELA BAS. SANITAS","13111","LA GRANJA","15","17","32"
"9610","ESCUELA BAS. POETA OSCAR CASTRO ZUNIGA","13111","LA GRANJA","20","18","38"
"9611","ESCUELA BASICA TUPAHUE","13131","SAN RAMON","17","5","22"
"9612","ESCUELA BASICA ISLAS DE CHILE","13111","LA GRANJA","15","16","31"
"9614","ESCUELA BASICA KARELMAPU","13131","SAN RAMON","11","8","19"
"9616","LICEO VICTOR JARA","13112","LA PINTANA","26","16","42"
"9617","LICEO MUNICIPAL LA GRANJA POETA NERUDA","13111","LA GRANJA","44","48","92"
"9618","ESCUELA BAS. BENJAMIN SUBERCASEAUX","13111","LA GRANJA","53","60","113"
"9620","ESCUELA BASICA JUAN DE DIOS ALDEA","13112","LA PINTANA","9","20","29"
"9625","ESCUELA BASICA VILLA LA CULTURA","13131","SAN RAMON","24","19","43"
"9629","ESCUELA BASICA ALIVEN","13131","SAN RAMON","22","30","52"
"9631","ESCUELA ESPECIAL DE ADULTOS","13131","SAN RAMON","24","17","41"
"9690","CENTRO DUC.CARDENAL JOSE MARIA CARO","13116","LO ESPEJO","1","2","3"
"9695","LICEO POLIVALENTE EUGENIO PEREIRA SALAS","13121","PEDRO AGUIRRE CERDA","10","15","25"
"9697","LICEO POLIVALENTE","13116","LO ESPEJO","4","4","8"
"9698","ESCUELA BASICA AVIADORES","13105","EL BOSQUE","11","11","22"
"9699","COLEGIO NACIONES UNIDAS","13109","LA CISTERNA","15","21","36"
"9700","COLEGIO PALESTINO","13109","LA CISTERNA","9","17","26"
"9701","LICEO POLIVALENTE OLOF PALME","13109","LA CISTERNA","11","19","30"
"9702","ESCUELA BASICA MARIO ARCE GATICA","13105","EL BOSQUE","19","18","37"
"9703","ESCUELA ESPERANZA JOVEN","13109","LA CISTERNA","6","21","27"
"9704","ESCUELA LO VALLEDOR","13121","PEDRO AGUIRRE CERDA","6","13","19"
"9705","ESCUELA BASICA SALOMON SACK","13116","LO ESPEJO","11","9","20"
"9706","ESCUELA BAS. OSCAR ENCALADA YOVANOVICH","13109","LA CISTERNA","12","23","35"
"9709","ESCUELA BLUE STAR COLLEGE","13116","LO ESPEJO","12","9","21"
"9710","ESCUELA BASICA SANTA ADRIANA","13116","LO ESPEJO","9","13","22"
"9713","COMPLEJO EDUCACIONAL FELIPE HERRERA LANE","13105","EL BOSQUE","19","16","35"
"9714","ESCUELA BASICA JOSE MARTI","13105","EL BOSQUE","21","17","38"
"9715","ESCUELA BASICA VILLA SANTA ELENA","13105","EL BOSQUE","16","13","29"
"9716","ESCUELA BASICA ACAPULCO","13116","LO ESPEJO","27","15","42"
"9717","ESCUELA CIUDAD DE LYON","13105","EL BOSQUE","12","12","24"
"9718","ESCUELA BASICA PAUL HARRIS","13105","EL BOSQUE","16","12","28"
"9719","ESCUELA BASICA","13116","LO ESPEJO","12","12","24"
"9720","COLEGIO HERNAN OLGUIN","13116","LO ESPEJO","54","42","96"
"9721","ESCUELA NEMESIO ANTUNEZ","13105","EL BOSQUE","15","10","25"
"9726","LICEO TENIENTE FRANCISCO MERY AGUIRRE","13116","LO ESPEJO","6","5","11"
"9727","ESCUELA CIUDAD DE BARCELONA","13121","PEDRO AGUIRRE CERDA","17","18","35"
"9729","ESCUELA VILLA SUR","13121","PEDRO AGUIRRE CERDA","11","15","26"
"9730","COLEGIO ANTU","13109","LA CISTERNA","16","21","37"
"9733","ESCUELA BASICA CLARA  ESTRELLA","13116","LO ESPEJO","18","20","38"
"9734","ESCUELA  RAUL SAEZ SAEZ","13116","LO ESPEJO","15","16","31"
"9736","ESCUELA BASICA BERNARDO O´HIGGINS","13116","LO ESPEJO","14","12","26"
"9738","COLEGIO PARQUE LAS AMERICAS","13121","PEDRO AGUIRRE CERDA","27","34","61"
"9740","ESCUELA BASICA REPUBLICA DE LAS FILIPINAS","13116","LO ESPEJO","8","9","17"
"9741","ESCUELA BASICA COEDUCACIONAL","13116","LO ESPEJO","12","26","38"
"9747","C.E.I.A.PEDRO AGUIRRE CERDA","13121","PEDRO AGUIRRE CERDA","2","13","15"
"9861","CENTRO EDUC.MUNIC. DR. AMADOR NECHME R.","13106","ESTACION CENTRAL","17","15","32"
"9863","LICEO SANTIAGO BUERAS Y AVARIA","13119","MAIPU","33","41","74"
"9864","LICEO JOSE IGNACIO ZENTENO","13119","MAIPU","17","22","39"
"9865","LICEO POLIVALENTE DR. LUIS VARGAS SALCEDO","13102","CERRILLOS","25","26","51"
"9867","CENTRO DE EDUC. TECN.PROFESIONAL CODEDUC","13119","MAIPU","17","24","41"
"9869","ESCUELA BASICA REPUBLICA DE FRANCIA","13106","ESTACION CENTRAL","11","7","18"
"9870","ESCUELA BASICA CONDORES DE PLATA","13102","CERRILLOS","10","16","26"
"9872","ESCUELA BASICA PROF.RAMON DEL RIO","13106","ESTACION CENTRAL","11","21","32"
"9873","ESCUELA BASICA PACTO ANDINO","13106","ESTACION CENTRAL","23","30","53"
"9874","ESCUELA LOTHAR KOMMER BRUGER","13102","CERRILLOS","9","12","21"
"9875","ESCUELA CERRILLOS","13102","CERRILLOS","12","23","35"
"9876","ESCUELA GENERAL SAN MARTIN","13119","MAIPU","29","30","59"
"9877","ESCUELA GENERAL OHIGGINS","13119","MAIPU","28","53","81"
"9878","ESCUELA PRESIDENTE RIESCO ERRAZURIZ","13119","MAIPU","31","45","76"
"9879","ESCUELA BASICA","13106","ESTACION CENTRAL","14","12","26"
"9880","ESCUELA BASICA JAPON","13106","ESTACION CENTRAL","9","12","21"
"9881","ESCUELA VICENTE REYES PALAZUELOS","13119","MAIPU","19","20","39"
"9882","ESCUELA J.PRIETO VIAL","13102","CERRILLOS","31","32","63"
"9883","ESCUELA BÁSICA N 263 RAMON FREIRE","13119","MAIPU","25","26","51"
"9884","ESCUELA LEON HUMBERTO VALENZUELA","13119","MAIPU","25","37","62"
"9886","ESCUELA ESTRELLA REINA DE CHILE","13102","CERRILLOS","19","19","38"
"9887","ESCUELA EL LLANO DE MAIPU","13119","MAIPU","7","13","20"
"9888","ESCUELA SANTA ADELA","13102","CERRILLOS","20","19","39"
"9889","LICEO REINO DE DINAMARCA","13119","MAIPU","18","20","38"
"9890","ESCUELA TOMAS VARGAS","13119","MAIPU","23","30","53"
"9891","REPUBLICA DE GUATEMALA","13119","MAIPU","27","27","54"
"9892","ESCUELA LAS AMERICAS","13119","MAIPU","36","46","82"
"9895","ESCUELA BASICA REINA DE SUECIA","13119","MAIPU","32","31","63"
"9985","LICEO GUILLERMO LABARCA HUBERTSON","13126","QUINTA NORMAL","8","3","11"
"9987","ESCUELA PLATON","13126","QUINTA NORMAL","11","11","22"
"9991","ESCUELA ABATE MOLINA","13126","QUINTA NORMAL","6","19","25"
"9992","ESCUELA DIEGO PORTALES","13126","QUINTA NORMAL","32","18","50"
"9993","ESCUELA INGLATERRA","13126","QUINTA NORMAL","18","27","45"
"9994","ESCUELA ANGELMO","13126","QUINTA NORMAL","12","26","38"
"9995","ESCUELA INSIGNE GABRIELA","13126","QUINTA NORMAL","61","0","61"
"9996","ESCUELA ESPANA","13126","QUINTA NORMAL","0","8","8"
"9998","ESCUELA LO FRANCO","13126","QUINTA NORMAL","30","34","64"
"9999","ESCUELA ANTUMALAL","13126","QUINTA NORMAL","4","8","12"
"10000","ESCUELA CALICANTO","13126","QUINTA NORMAL","19","17","36"
"10001","ESCUELA MEMBRILLAR","13126","QUINTA NORMAL","22","11","33"
"10005","ESCUELA BASICA MUNICIPAL GRENOBLE","13126","QUINTA NORMAL","28","38","66"
"10006","ESCUELA REPUBLICA DE LA INDIA","13126","QUINTA NORMAL","17","23","40"
"10010","MUSTAFA KEMAL ATATURK","13117","LO PRADO","15","11","26"
"10012","ESCUELA GIL DE CASTRO","13126","QUINTA NORMAL","10","13","23"
"10074","ESCUELA ALIANZA","13103","CERRO NAVIA","14","18","32"
"10076","COMPLEJO EDUCACIONAL PEDRO PRADO","13117","LO PRADO","14","16","30"
"10080","ESCUELA TENIENTE HERNAN MERINO CORREA","13124","PUDAHUEL","26","11","37"
"10081","ESCUELA ESTRELLA DE CHILE","13124","PUDAHUEL","60","62","122"
"10083","ESCUELA PRESIDENTE ROOSEVELT","13103","CERRO NAVIA","32","25","57"
"10085","ESCUELA ESTADO DE FLORIDA","13124","PUDAHUEL","22","38","60"
"10086","ESCUELA REPUBLICA DE ITALIA","13103","CERRO NAVIA","19","23","42"
"10087","ESCUELA REPUBLICA DE CROACIA","13103","CERRO NAVIA","16","20","36"
"10088","ESCUELA HERMINDA DE LA VICTORIA","13103","CERRO NAVIA","9","15","24"
"10089","ESCUELA JAIME GOMEZ GARCIA","13117","LO PRADO","23","17","40"
"10090","ESCUELA ALEXANDER GRAHAM BELL","13124","PUDAHUEL","26","33","59"
"10091","ESCUELA PROFESORA GLADYS VALENZUELA V","13117","LO PRADO","26","18","44"
"10092","ESCUELA GOLDA MEIR","13117","LO PRADO","7","17","24"
"10093","ESCUELA MILLAHUE","13103","CERRO NAVIA","15","14","29"
"10095","ESCUELA IGNACIO CARRERA PINTO","13117","LO PRADO","8","9","17"
"10097","ESCUELA MARISCAL DE AYACUCHO","13117","LO PRADO","14","7","21"
"10098","ESCUELA PROVINCIA DE ARAUCO","13103","CERRO NAVIA","13","14","27"
"10099","ESCUELA GENERAL RENE ESCAURIAZA","13103","CERRO NAVIA","11","23","34"
"10100","ESCUELA EL SALITRE","13124","PUDAHUEL","14","25","39"
"10102","ESCUELA ALBERT EINSTEIN","13124","PUDAHUEL","7","19","26"
"10103","ESCUELA SOR TERESA DE LOS ANDES","13117","LO PRADO","30","38","68"
"10104","ESCUELA MONSENOR CARLOS OVIEDO","13124","PUDAHUEL","17","18","35"
"10105","ESCUELA FEDERICO ACEVEDO SALAZAR","13103","CERRO NAVIA","17","37","54"
"10106","ESCUELA POETA PABLO NERUDA","13117","LO PRADO","18","16","34"
"10107","ESCUELA BASICA PAULO FREIRE","13103","CERRO NAVIA","13","10","23"
"10108","ESCUELA LEONARDO DA VINCI","13103","CERRO NAVIA","11","16","27"
"10109","ESCUELA DOCTOR TREVISO GIRARDI TONELLI","13103","CERRO NAVIA","11","12","23"
"10113","ESCUELA ELVIRA SANTA CRUZ OSSA","13124","PUDAHUEL","36","25","61"
"10114","ESCUELA BASICA N°389 REPUBLICA DE ESTADOS UNIDOS","13117","LO PRADO","18","31","49"
"10116","COLEGIO NEPTUNO","13103","CERRO NAVIA","10","16","26"
"10117","ESCUELA MARIA LUISA BOMBAL","13103","CERRO NAVIA","15","25","40"
"10119","ESCUELA POETA VICENTE HUIDOBRO","13117","LO PRADO","16","15","31"
"10120","LICEO DE ADULTOS ALBERTO GALLEGUILLOS J.","13124","PUDAHUEL","16","12","28"
"10121","ESCUELA CIUDAD SANTO DOMINGO DE GUZMAN","13103","CERRO NAVIA","10","11","21"
"10122","ESCUELA PROF. MANUEL GUERRERO CEBALLOS","13103","CERRO NAVIA","23","30","53"
"10123","ESCUELA BASICA MELVIN JONES","13124","PUDAHUEL","12","21","33"
"10124","ESCUELA SAN DANIEL","13124","PUDAHUEL","23","16","39"
"10125","ESCUELA SARGENTO CANDELARIA","13103","CERRO NAVIA","7","14","21"
"10126","COMPLEJO EDUCACIONAL CERRO NAVIA","13103","CERRO NAVIA","11","10","21"
"10130","LICEO CIUDAD DE BRASILIA","13124","PUDAHUEL","18","25","43"
"10134","ESC.COMODORO ARTURO MERINO BENITEZ","13124","PUDAHUEL","16","14","30"
"10135","ESCUELA LO BOZA","13124","PUDAHUEL","9","16","25"
"10197","ESCUELA JUANA DE LESTONAC","13128","RENCA","31","0","31"
"10199","LICEO POLIVALENTE A80 PRESIDENTE JOSE MANUEL BALMACEDA","13108","INDEPENDENCIA","17","26","43"
"10200","ESCUELA BASICA ISABEL LE BRUN","13128","RENCA","99","0","99"
"10201","LICEO THOMAS ALVA EDISON","13128","RENCA","21","22","43"
"10202","ESCUELA DOMINGO SANTA MARIA GONZALEZ","13128","RENCA","0","66","66"
"10204","ESCUELA CAPITAN JOSE LUIS ARANEDA","13128","RENCA","17","15","32"
"10205","ESCUELA GENERAL MANUEL BULNES PRIETO","13128","RENCA","13","12","25"
"10207","ESCUELA REBECA MATTE BELLO","13128","RENCA","41","35","76"
"10210","ESCUELA GENERAL ALEJANDRO GOROSTIAGA O","13128","RENCA","15","14","29"
"10212","ESCUELA JUANA ATALA DE HIRMAS","13128","RENCA","19","20","39"
"10216","ESC. BASICA MONSERRAT ROBERT DE GARCIA","13128","RENCA","13","13","26"
"10239","ESCUELA ESTADO DE MICHIGAN","13125","QUILICURA","33","41","74"
"10240","ESCUELA LUIS CRUZ MARTINEZ","13125","QUILICURA","45","58","103"
"10241","ESCUELA BASICA EL MANIO","13125","QUILICURA","7","26","33"
"10250","CENTRO EDUCACIONAL DE HUECHURABA","13107","HUECHURABA","19","25","44"
"10251","LICEO POETA FEDERICO GARCIA LORCA","13104","CONCHALI","13","9","22"
"10252","LICEO ARTURO PEREZ CANTO","13127","RECOLETA","15","31","46"
"10253","LICEO POLIV. ABDON CIFUENTES","13104","CONCHALI","15","18","33"
"10254","CENTRO EDUCACIONAL JOSE MIGUEL CARRERA","13127","RECOLETA","3","3","6"
"10257","ESCUELA SARGENTO 2. DANIEL REBOLLEDO","13127","RECOLETA","19","28","47"
"10259","LICEO AGUSTIN EDWARDS","13104","CONCHALI","12","21","33"
"10260","ESCUELA UNESCO","13104","CONCHALI","12","19","31"
"10262","ESCUELA ESPANA","13127","RECOLETA","12","27","39"
"10263","ESCUELA D-114","13104","CONCHALI","13","16","29"
"10264","ESCUELA SOL NACIENTE","13104","CONCHALI","12","12","24"
"10265","ESCUELA HORACIO JOHNSON GANA","13104","CONCHALI","13","14","27"
"10266","ESCUELA DRA.ELOISA DIAZ INSUNZA","13104","CONCHALI","33","34","67"
"10267","ESCUELA ESCRITORA MARCELA PAZ","13127","RECOLETA","12","26","38"
"10268","ESCUELA PUERTO RICO","13127","RECOLETA","13","29","42"
"10269","LICEO MUNC.ALMIRANTE GALVARINO RIVEROS","13104","CONCHALI","12","12","24"
"10270","CENTRO EDUC.ESCRITORES DE CHILE","13127","RECOLETA","28","42","70"
"10271","ESCUELA ARAUCARIAS DE CHILE","13104","CONCHALI","9","15","24"
"10272","ESCUELA BASICA CARLOS PRATS G.","13107","HUECHURABA","17","12","29"
"10273","ESCUELA VALLE DEL INCA","13104","CONCHALI","23","25","48"
"10277","ESCUELA ADELAIDA LA FETRA","13107","HUECHURABA","17","26","43"
"10278","ESCUELA PEDRO AGUIRRE CERDA","13104","CONCHALI","9","14","23"
"10279","ESCUELA ALLIPEN","13104","CONCHALI","14","9","23"
"10280","CENTRO EDUC. POETA EUSEBIO LILLO","13104","CONCHALI","18","10","28"
"10281","ESCUELA ATENEA","13104","CONCHALI","51","0","51"
"10282","ESCUELA LUIS GALDAMES","13108","INDEPENDENCIA","9","18","27"
"10283","ESCUELA AVIADOR DAGOBERTO GODOY F.","13104","CONCHALI","16","26","42"
"10285","ESCUELA SANTA VICTORIA DE HUECHURABA","13107","HUECHURABA","25","16","41"
"10288","ESCUELA BASICA LIKAN-ANTAI","13104","CONCHALI","2","12","14"
"10290","ESCUELA LAS CANTERAS","13107","HUECHURABA","17","26","43"
"10291","ESCUELA VICTOR CUCCUINI","13127","RECOLETA","14","16","30"
"10300","ESCUELA MARTA COLVIN","13127","RECOLETA","8","15","23"
"10301","ESCUELA CAMILO HENRIQUEZ","13104","CONCHALI","15","35","50"
"10302","ESCUELA ANNE ELEONOR ROOSEVELT","13127","RECOLETA","9","12","21"
"10305","ESCUELA SANTIAGO DE GUAYAQUIL","13107","HUECHURABA","22","18","40"
"10306","ESCUELA MUN.HERMANA MARIA GORETTI","13127","RECOLETA","4","16","20"
"10307","ESCUELA RAFAEL VALDIVIESO","13127","RECOLETA","18","35","53"
"10400","ESCUELA BASICA MARCOS GOOYCOLEA CORTES","13301","COLINA","46","36","82"
"10401","ESCUELA BASICA SANTA TERESA DEL CARMELO","13301","COLINA","30","26","56"
"10403","ESCUELA PREMIO NOBEL PABLO NERUDA","13301","COLINA","26","25","51"
"10404","ANDALIEN DE COLINA","13301","COLINA","23","29","52"
"10405","LICEO ESMERALDA","13301","COLINA","20","21","41"
"10407","ESCUELA BASICA ALGARROBAL","13301","COLINA","32","34","66"
"10408","LICEO CORONEL ENRIQUE CABRERA JIMENEZ","13301","COLINA","13","17","30"
"10409","ESC.BASICA FRANCISCO PETRINOVIC KARLOVAC","13301","COLINA","13","18","31"
"10410","ESCUELA BASICA SAN VICENTE DE LO ARCAYA","13301","COLINA","17","18","35"
"10411","ESCUELA BASICA SANTA MARTA DE LIRAY","13301","COLINA","20","14","34"
"10412","ESCUELA SAN FRANCISCO DE ASIS","13301","COLINA","6","7","13"
"10420","ESCUELA MANUEL SEGOVIA MONTENEGRO","13302","LAMPA","44","76","120"
"10421","ESCUELA REPUBLICA DE POLONIA","13302","LAMPA","18","22","40"
"10422","ESCUELA BASICA CACIQUE COLIN","13302","LAMPA","31","20","51"
"10424","ESCUELA SANTA  BARBARA","13302","LAMPA","23","14","37"
"10425","ESCUELA POLONIA GUTIERREZ C.","13302","LAMPA","29","38","67"
"10426","ESCUELA BASICA F-N°371 SANTA ROSA DE LAMPA","13302","LAMPA","10","15","25"
"10427","ESCUELA BASICA F - N°372 SANTA SARA","13302","LAMPA","6","11","17"
"10428","ESCUELA BASICA G-N°373 EL LUCERO","13302","LAMPA","9","14","23"
"10429","NORMA GONZÁLEZ GUERRA","13302","LAMPA","16","19","35"
"10432","LICEO POLIVALENTE MANUEL RODRIGUEZ","13303","TILTIL","27","31","58"
"10433","LICEO HUERTOS FAMILIARES","13303","TILTIL","22","22","44"
"10435","ESCUELA BASICA G-N°345 RUNGUE","13303","TILTIL","13","7","20"
"10436","ESCUELA BASICA G-N° 346","13303","TILTIL","6","7","13"
"10441","ESCUELA BASICA G-N°349","13303","TILTIL","2","2","4"
"10443","LICEO MONTENEGRO","13303","TILTIL","2","5","7"
"10444","ESCUELA BASICA G-N°352 PLAZUELA DE POLPAICO","13303","TILTIL","11","4","15"
"10450","ESCUELA CONSOLIDADA","13201","PUENTE ALTO","59","64","123"
"10452","LICEO PUENTE ALTO","13201","PUENTE ALTO","4","13","17"
"10455","LICEO SAN GERONIMO","13201","PUENTE ALTO","31","18","49"
"10457","COLEGIO MAIPO","13201","PUENTE ALTO","42","40","82"
"10458","ESCUELA VILLA INDEPENDENCIA","13201","PUENTE ALTO","48","58","106"
"10459","ESCUELA REPUBLICA DE GRECIA","13201","PUENTE ALTO","22","21","43"
"10461","ESCUELA LOS ANDES","13201","PUENTE ALTO","28","26","54"
"10462","ESCUELA NONATO COO","13201","PUENTE ALTO","31","39","70"
"10464","ESCUELA VILLA PEDRO AGUIRRE CERDA","13201","PUENTE ALTO","11","20","31"
"10465","ESCUELA EJERCITO LIBERTADOR","13201","PUENTE ALTO","41","33","74"
"10470","LICEO MUNIC.ING.MILITAR JUAN MACKENA O.","13201","PUENTE ALTO","28","39","67"
"10472","ESCUELA CASAS VIEJAS","13201","PUENTE ALTO","17","27","44"
"10473","ESCUELA OSCAR BONILLA","13201","PUENTE ALTO","26","30","56"
"10474","ESCUELA LUIS MATTE LARRAIN","13201","PUENTE ALTO","60","102","162"
"10475","ESCUELA GABRIELA","13201","PUENTE ALTO","46","40","86"
"10476","ESCUELA LAS PALMAS","13201","PUENTE ALTO","47","42","89"
"10516","LICEO MUNIC. TEC. PROF. EL LLANO","13202","PIRQUE","18","18","36"
"10519","ESCUELA BASICA G-N°646 LO ARCAYA","13202","PIRQUE","14","12","26"
"10520","LICEO  EL PRINCIPAL","13202","PIRQUE","41","41","82"
"10524","ESCUELA BASICA G-841 SANTOS RUBIO MORALES","13202","PIRQUE","15","15","30"
"10527","ESCUELA JULIETA BECERRA ALVAREZ","13203","SAN JOSE DE MAIPO","30","18","48"
"10528","ESCUELA BASICA F-N°632 EL CANELO","13203","SAN JOSE DE MAIPO","8","7","15"
"10529","ESCUELA BASICA F-N°638 EL MELOCOTON","13203","SAN JOSE DE MAIPO","7","7","14"
"10530","ESCUELA BASICA F-N°629 DE CONCENTRACION FRONTERIZA","13203","SAN JOSE DE MAIPO","4","9","13"
"10536","ESCUELA BASICA G-N°635 INTEGRADORA EL MANZANO","13203","SAN JOSE DE MAIPO","7","4","11"
"10537","ESCUELA BASICA G-N°636 SAN ALFONSO","13203","SAN JOSE DE MAIPO","6","3","9"
"10542","CENTRO EDUCACIONAL BALDOMERO LILLO","13401","SAN BERNARDO","21","27","48"
"10546","ESCUELA PILAR MOLINER DE NUEZ","13401","SAN BERNARDO","86","0","86"
"10547","ESCUELA REPUBLICA DEL BRASIL","13401","SAN BERNARDO","0","31","31"
"10548","ESCUELA ISABEL RIQUELME","13401","SAN BERNARDO","27","0","27"
"10550","ESCUELA L.GRAL. BERNARDO O´HIGGINS","13401","SAN BERNARDO","8","18","26"
"10551","LICEO POLIV. LUCILA GODOY ALCAYAGA","13401","SAN BERNARDO","3","7","10"
"10553","ESCUELA MARCIAL MARTINEZ FERRARI","13105","EL BOSQUE","35","38","73"
"10554","ESCUELA GENERAL RENE SCHNEIDER CHEREAU","13401","SAN BERNARDO","22","13","35"
"10555","ESCUELA BASICA BASE EL BOSQUE","13105","EL BOSQUE","21","25","46"
"10556","ESCUELA ALEMANIA","13401","SAN BERNARDO","29","30","59"
"10557","ESCUELA GENERAL ALBERTO A. BACHELET MARTINEZ","13105","EL BOSQUE","27","30","57"
"10558","ESCUELA REPUBLICA DE LOS EE.UU. DE AMERICA","13401","SAN BERNARDO","7","8","15"
"10559","ESCUELA BERNARDO LEIGHTON","13105","EL BOSQUE","11","14","25"
"10560","ESCUELA JAVIERA CARRERA VERDUGO","13401","SAN BERNARDO","15","10","25"
"10561","ESCUELA CLAUDIO ARRAU LEON","13105","EL BOSQUE","11","15","26"
"10563","ESCUELA MANUEL MAGALLANES MOURE","13401","SAN BERNARDO","0","42","42"
"10564","ESCUELA REPUBLICA DEL PERU","13401","SAN BERNARDO","56","0","56"
"10565","ESCUELA DIEGO PORTALES","13401","SAN BERNARDO","38","41","79"
"10567","ESCUELA MAHUIDA","13401","SAN BERNARDO","2","12","14"
"10568","ESCUELA ORLANDO LETELIER","13105","EL BOSQUE","11","8","19"
"10569","LICEO NUEVO PORVENIR","13401","SAN BERNARDO","18","17","35"
"10570","ESCUELA BASICA DR LUIS SEPULVEDA SALVATI","13401","SAN BERNARDO","15","15","30"
"10571","ESCUELA ESCRITORA  MARCELA PAZ","13401","SAN BERNARDO","24","15","39"
"10572","LICEO FRAY LUIS BELTRAN","13105","EL BOSQUE","2","6","8"
"10573","CENTRO EDUCACIONAL MATIAS COUSINO","13105","EL BOSQUE","0","10","10"
"10574","ESCUELA ESPANA","13401","SAN BERNARDO","7","11","18"
"10576","ESCUELA IGNACIO CARRERA PINTO","13401","SAN BERNARDO","5","10","15"
"10578","ESCUELA STA. TERESA DE LOS MORROS","13401","SAN BERNARDO","43","37","80"
"10579","ESCUELA JOSE NUEZ MARTIN","13401","SAN BERNARDO","13","31","44"
"10580","ESCUELA ABRAHAM LINCOLN","13401","SAN BERNARDO","19","21","40"
"10581","ESCUELA BASICA ANTUPILLAN","13401","SAN BERNARDO","26","15","41"
"10584","LICEO DE ADULTOS PUCARA DE CHENA","13401","SAN BERNARDO","6","2","8"
"10586","ESCUELA ELEODORO YANEZ PONCE DE LEON","13401","SAN BERNARDO","11","19","30"
"10588","ESCUELA CARDENAL ANTONIO SAMORE","13401","SAN BERNARDO","31","26","57"
"10589","ESCUELA HARAS LOS CONDORES","13401","SAN BERNARDO","17","21","38"
"10590","ESCUELA TERESA GARCIA HUIDOBRO","13401","SAN BERNARDO","3","9","12"
"10592","LICEO CLARA SOLOVERA","13401","SAN BERNARDO","18","17","35"
"10638","LICEO 131","13402","BUIN","72","81","153"
"10640","COLEGIO DE MAIPO","13402","BUIN","17","19","36"
"10641","LICEO ALTO JAHUEL","13402","BUIN","29","36","65"
"10643","ESCUELA VILLASECA","13402","BUIN","17","14","31"
"10645","LICEO FRANCISCO JAVIER KRUGGER ALVARADO","13402","BUIN","16","36","52"
"10646","ESCUELA VALDIVIA DE PAINE","13402","BUIN","20","26","46"
"10648","ESCUELA LO SALINAS","13402","BUIN","16","11","27"
"10649","ESCUELA HUMBERTO MORENO RAMIREZ","13402","BUIN","14","15","29"
"10651","ESCUELA LOS ROSALES DEL BAJO","13402","BUIN","41","36","77"
"10652","ESCUELA VILUCO","13402","BUIN","13","10","23"
"10656","ESCUELA BASICA G-N°813 LOS AROMOS DE EL RECURSO","13402","BUIN","15","15","30"
"10665","ESCUELA ALEMANIA","13404","PAINE","31","9","40"
"10666","ESCUELA DE HOSPITAL","13404","PAINE","15","13","28"
"10667","LICEO  MARIA CARVAJAL FUENZALIDA","13404","PAINE","21","10","31"
"10668","ESCUELA ELIAS SANCHEZ ORTUZAR","13404","PAINE","15","24","39"
"10669","ESCUELA  BARBARA KAST RIST","13404","PAINE","15","23","38"
"10671","ESCUELA CARMEN REVECO NUNEZ","13404","PAINE","8","10","18"
"10672","COLEGIO  CHALLAY","13404","PAINE","11","9","20"
"10673","ESCUELA BASICA F-N°835 HERMANOS SANCHEZ CERDA","13404","PAINE","23","17","40"
"10674","ESCUELA SENDERO DE CULITRIN","13404","PAINE","7","17","24"
"10675","ESCUELA  LAS COLONIAS","13404","PAINE","14","10","24"
"10676","ESCUELA BASICA G-N°830 FRANCISCO LETELIER VALDES","13404","PAINE","9","8","17"
"10677","ESCUELA BASICA G N°831 JAVIER EYZAGUIRRE ECHAURREN","13404","PAINE","13","12","25"
"10679","ESCUELA  BASICA G-N°832 AGUILA SUR","13404","PAINE","5","9","14"
"10680","ESCUELA HUGO PINO VILCHEZ","13404","PAINE","22","23","45"
"10686","LICEO MUNICIPAL POETISA GABRIELA MISTRAL","13403","CALERA DE TANGO","34","25","59"
"10687","ESCUELA BASICA F-N°798 CALERA DE TANGO","13403","CALERA DE TANGO","25","16","41"
"10688","LICEO LONQUEN","13403","CALERA DE TANGO","26","28","54"
"10689","ESCUELA EL ROTO CHILENO","13601","TALAGANTE","12","14","26"
"10696","LICEO POLIVALENTE TALAGANTE","13601","TALAGANTE","6","15","21"
"10698","ESCUELA TALACANTA","13601","TALAGANTE","6","11","17"
"10699","ESCUELA REPUBLICA DE GRECIA","13601","TALAGANTE","32","40","72"
"10702","ESCUELA MANUEL RODRIGUEZ ERDOIZA","13601","TALAGANTE","8","16","24"
"10704","ESCUELA ALBORADA DE TALAGANTE","13601","TALAGANTE","49","46","95"
"10705","ESCUELA LUIS UNDURRAGA","13601","TALAGANTE","22","14","36"
"10706","ESCUELA EL PINO VIEJO DE LONQUEN","13601","TALAGANTE","8","5","13"
"10726","CENTRO DE EDUCACION MARIO BERTERO CEVASCO","13603","ISLA DE MAIPO","42","40","82"
"10727","LICEO REPUBLICA DE ITALIA","13603","ISLA DE MAIPO","22","35","57"
"10729","ESCUELA BASICA EFRAIN MALDONADO TORRES","13603","ISLA DE MAIPO","26","34","60"
"10730","ESC.BASICA SAN ANTONIO DE NALTAGUA","13603","ISLA DE MAIPO","7","10","17"
"10735","LICEO POLIV. LUIS HUMBERTO ACOSTA GAY","13602","EL MONTE","13","3","16"
"10736","ESCUELA REPUBLICA DEL ECUADOR","13602","EL MONTE","9","12","21"
"10737","ESC. BASICA  JAVIERA CARRERA VERDUGO","13602","EL MONTE","12","9","21"
"10738","ESCUELA REPUBLICA DE HONDURAS","13602","EL MONTE","31","28","59"
"10740","ESCUELA CHINIGUE EL CRISTO","13602","EL MONTE","9","5","14"
"10741","ESCUELA EL REMANSO","13602","EL MONTE","8","8","16"
"10747","ESCUELA TERESA DE CALCUTA","13605","PEÑAFLOR","19","16","35"
"10748","ESCUELA EMILIA LASCAR","13605","PEÑAFLOR","61","50","111"
"10749","LICEO PAUL HARRIS","13604","PADRE HURTADO","22","19","41"
"10750","ESCUELA ROSALINA PESCIO VARGAS","13605","PEÑAFLOR","59","55","114"
"10752","ESCUELA REPUBLICA ARGENTINA","13604","PADRE HURTADO","16","18","34"
"10753","ESCUELA REPUBLICA CHECA","13605","PEÑAFLOR","10","20","30"
"10754","ESCUELA MAND EDUARDO FREI MONTALVA","13605","PEÑAFLOR","24","19","43"
"10756","ESCUELA SONIA PLAZA CASTRO","13605","PEÑAFLOR","8","9","17"
"10758","ESCUELA MALLOCO","13605","PEÑAFLOR","28","26","54"
"10760","ESCUELA REPUBLICA DE ISRAEL","13605","PEÑAFLOR","18","16","34"
"10763","ESCUELA CRISTAL CHILE","13604","PADRE HURTADO","21","18","39"
"10764","ESCUELA LA ESPERANZA","13604","PADRE HURTADO","11","15","26"
"10766","ESCUELA DOLORES CATTIN FAUNDEZ","13605","PEÑAFLOR","1","5","6"
"10782","ESCUELA IGNACIO SERRANO MONTANER","13501","MELIPILLA","0","28","28"
"10783","LICEO GABRIELA MISTRAL DE MELIPILLA","13501","MELIPILLA","44","18","62"
"10784","COLEGIO HUILCO ALTO","13501","MELIPILLA","7","9","16"
"10785","COLEGIO MONS. JAIME LARRAIN BUNSTER","13501","MELIPILLA","10","17","27"
"10786","ESCUELA SAN JOSE DE LA VILLA","13501","MELIPILLA","12","27","39"
"10789","ESCUELA GRAL. CAROL URZUA","13501","MELIPILLA","4","19","23"
"10790","ESCUELA REPUBLICA DEL BRASIL","13501","MELIPILLA","23","30","53"
"10791","COLEGIO POMAIRE","13501","MELIPILLA","19","24","43"
"10792","LICEO POLIV. EL BOLLENAR","13501","MELIPILLA","15","22","37"
"10794","ESCUELA SANTA ROSA ESMERALDA","13501","MELIPILLA","8","23","31"
"10795","ESCUELA CLAUDIO ARRAU","13501","MELIPILLA","15","8","23"
"10796","ESCUELA PATRICIO LARRAIN GANDARILLAS","13501","MELIPILLA","11","11","22"
"10797","ESCUELA PEDRO MARIN ALEMANY","13501","MELIPILLA","14","18","32"
"10798","ESCUELA BASICA CARMEN BAJO","13501","MELIPILLA","11","9","20"
"10799","ESCUELA RAMON NOGUERA PRIETO","13501","MELIPILLA","15","15","30"
"10805","ESCUELA PUANGUE","13501","MELIPILLA","7","9","16"
"10810","ESCUELA LIDIA MATTE HURTADO","13501","MELIPILLA","6","10","16"
"10816","ESCUELA JOSE CAMARENA ESCRIVA","13501","MELIPILLA","7","8","15"
"10818","ESCUELA HUECHUN","13501","MELIPILLA","18","12","30"
"10821","ESCUELA RAQUEL FERNANDEZ DE MORANDE","13501","MELIPILLA","6","6","12"
"10827","ESCUELA BASICA EL PABELLON","13501","MELIPILLA","13","12","25"
"10835","LICEO MUNICIPAL F-N°860","13504","MARIA PINTO","18","13","31"
"10836","ESCUELA BASICA F-N° 732 CHOROMBO ALTO","13504","MARIA PINTO","18","16","34"
"10837","ESCUELA BASICA F-N°738 LOS RULOS","13504","MARIA PINTO","9","12","21"
"10838","ESCUELA BASICA G-N°733 CHOROMBO BAJO","13504","MARIA PINTO","11","6","17"
"10839","ESCUELA BASICA G-N°734 LAS MERCEDES","13504","MARIA PINTO","7","10","17"
"10840","ESCUELA BASICA G-N°737 SANTA EMILIA","13504","MARIA PINTO","11","9","20"
"10842","ESCUELA BASICA VALLE DE PUANGUE","13503","CURACAVI","18","36","54"
"10844","ESCUELA SAN JOSE OBRERO DE CURACAVI","13503","CURACAVI","35","38","73"
"10846","ESCUELA FERNANDO CARVAJAL PINTO","13503","CURACAVI","17","14","31"
"10848","ESCUELA ELIECER PEREZ VARGAS","13503","CURACAVI","7","24","31"
"10854","LICEO MUNICIPAL DE SAN PEDRO","13505","SAN PEDRO","26","31","57"
"10856","ESCUELA BASICA G-N°126","13505","SAN PEDRO","6","7","13"
"10858","ESCUELA BASICA G-N°128 ATALICIO AGUILAR A.","13505","SAN PEDRO","4","3","7"
"10862","ESCUELA BASICA G-N°131","13505","SAN PEDRO","8","7","15"
"10864","ESCUELA BASICA G-N°134 NIHUE","13505","SAN PEDRO","7","8","15"
"10865","ESCUELA ENRIQUE REYMOND ALDUNATE","13505","SAN PEDRO","2","3","5"
"10871","ESCUELA BASICA G-N°498","13505","SAN PEDRO","2","5","7"
"10873","LICEO MUNICIPAL SARA TRONCOSO TRONCOSO","13502","ALHUE","22","27","49"
"10877","ESCUELA EL ASIENTO","13502","ALHUE","4","4","8"
"10879","ESCUELA SAN ALFONSO","13502","ALHUE","11","8","19"
"10880","ESCUELA HACIENDA ALHUE","13502","ALHUE","3","4","7"
"10905","ESCUELA BASICA FUERTE BAQUEDANO","1401","POZO ALMONTE","15","8","23"
"10916","ESCUELA CALETA CHANAVAYITA","1101","IQUIQUE","2","9","11"
"10917","LICEO S.S JUAN PABLO SEGUNDO","1107","ALTO HOSPICIO","62","96","158"
"10970","LICEO JORGE ALESSANDRI RODRIGUEZ","2201","CALAMA","14","12","26"
"11025","ESCUELA FRONTERIZA","3302","ALTO DEL CARMEN","6","8","14"
"11033","ESCUELA BASICA ANGELINA SALAS OLIVARES","3201","CHAÑARAL","24","26","50"
"11111","LICEO ALBERTO GALLARDO LORCA","4304","PUNITAQUI","9","12","21"
"11155","LICEO JORGE ALESSANDRI RODRIGUEZ","4101","LA SERENA","10","17","27"
"11199","COLEGIO LUIS CRUZ MARTINEZ","5401","LA LIGUA","23","31","54"
"11246","LICEO ELISA ESCOBEDO LA PAZ","6115","RENGO","3","11","14"
"11248","ESC. ADRIANA ARANGUIZ CERDA","6117","SAN VICENTE","15","20","35"
"11261","ESCUELA DIGNA CAMILO","6201","PICHILEMU","22","14","36"
"11277","ESCUELA GABRIELA MISTRAL","6110","MOSTAZAL","27","24","51"
"11284","CENTRO DE EDUCACION DE ADULTOS","6101","RANCAGUA","13","14","27"
"11286","LICEO HERIBERTO SOTO SOTO","6301","SAN FERNANDO","14","11","25"
"11287","LICEO BERTA ZAMORANO LIZANA","6104","COLTAUCO","1","2","3"
"11323","ESCUELA REINO DE DINAMARCA","7304","MOLINA","23","29","52"
"11333","ESCUELA OSVALDO HIRIART CORVALAN","7107","PENCAHUE","4","1","5"
"11337","CENTRO DE EDUCACION INTEGRADA DE ADULTOS","7406","SAN JAVIER","8","9","17"
"11342","ESCUELA CARLOS TRUPP WANNER","7101","TALCA","14","31","45"
"11394","ESCUELA GABRIELA MISTRAL","8111","TOME","43","54","97"
"11398","ESCUELA MAULE","8102","CORONEL","13","16","29"
"11405","ESCUELA FERNANDO BAQUEDANO","8421","YUNGAY","35","44","79"
"11417","ESCUELA ADULTOS LAS AMERICAS","8110","TALCAHUANO","10","14","24"
"11462","ESCUELA COLONIA RAYEN-LAFQUEN","9120","VILLARRICA","2","1","3"
"11472","ESCUELA ARAUCARIAS","9109","LONCOCHE","8","15","23"
"11548","ESCUELA CLAUDIO MATTE","10105","FRUTILLAR","15","23","38"
"11553","ESCUELA RURAL NALHUITAD","10203","CHONCHI","1","2","3"
"11591","LICEO RURAL LLIFEN","14202","FUTRONO","11","13","24"
"11677","ESCUELA ANDRES ALCAZAR","8304","LAJA","60","40","100"
"11687","ESCUELA REPUBLICA ARGENTINA","12101","PUNTA ARENAS","19","14","33"
"11704","ESCUELA PUERTA DE LA CORDILLERA","8411","PINTO","41","27","68"
"11711","ESCUELA LUIS MARTÍNEZ GONZÁLEZ","8312","TUCAPEL","37","42","79"
"11714","ESCUELA CHACUIVI","8207","TIRUA","1","10","11"
"11743","COLEGIO BASICO LOS LOBOS","8110","TALCAHUANO","22","26","48"
"11993","ESCUELA BASICA JUAN PABLO DUARTE","13123","PROVIDENCIA","38","51","89"
"12020","ESCUELA BASICA ENRIQUE ZANARTU PRIETO","8303","CABRERO","37","43","80"
"12022","ESCUELA BASICA CHACAYAL SUR","8301","LOS ANGELES","6","13","19"
"12023","COLEGIO BASICO SAN VICENTE","8110","TALCAHUANO","10","14","24"
"12058","ESCUELA BASICA LOS LIBERTADORES","8105","HUALQUI","18","38","56"
"12079","HERNAN MERINO CORREA","13401","SAN BERNARDO","24","27","51"
"12113","ESCUELA BASICA LO VELASQUEZ","13128","RENCA","9","19","28"
"12146","CENTRO INTEG EDUC ADULTOS DE PLAYA ANCHA","5101","VALPARAISO","20","17","37"
"12171","ESCUELA BASICA HUMBERTO VILCHEZ ALZAMORA","5109","VIÑA DEL MAR","9","19","28"
"12243","ESCUELA Nº 1365 R.P. GUSTAVO LE PAIGE","13128","RENCA","15","16","31"
"12251","COLEGIO BATALLA DE LA CONCEPCION","13105","EL BOSQUE","15","12","27"
"12255","COLEGIO ALCAZAR","13119","MAIPU","59","66","125"
"12314","ESCUELA ATENAS","5803","OLMUE","15","22","37"
"12501","ESCUELA JORGE ALESSANDRI RODRIGUEZ","15101","ARICA","19","11","30"
"12538","ESCUELA CHIPANA","1101","IQUIQUE","15","22","37"
"12542","ESCUELA CALETA SAN MARCOS","1101","IQUIQUE","3","4","7"
"12550","OASIS EN EL DESIERTO","1401","POZO ALMONTE","4","0","4"
"12617","ESCUELA ESTRELLA DEL SUR","1401","POZO ALMONTE","35","38","73"
"12623","ESCUELA SAN ANDRES DE PICA","1405","PICA","14","18","32"
"12632","COLEGIO SIMON BOLIVAR","1107","ALTO HOSPICIO","12","17","29"
"12683","LICEO COLEGIO DEPORTIVO","1101","IQUIQUE","6","39","45"
"12758","LICEO C.E.I.A. JOSE ALEJANDRO SORIA VARAS","1101","IQUIQUE","22","31","53"
"12810","ESCUELA KAMAC MAYU","2201","CALAMA","42","57","99"
"12840","ESCUELA JUAN PABLO II","2101","ANTOFAGASTA","47","44","91"
"12842","LICEO AGROPECUARIO LIKAN ANTAI","2203","SAN PEDRO DE ATACAMA","38","39","77"
"12870","C.E.I.A. ANTONIO RENDIC.","2101","ANTOFAGASTA","40","52","92"
"12871","ESCUELA BASICA VALENTIN LETELIER","2201","CALAMA","45","36","81"
"12872","ESCUELA MARÍA ANGÉLICA ELIZONDO BRICEÑO","2102","MEJILLONES","26","14","40"
"12942","ESCUELA GABRIELA MISTRAL","2301","TOCOPILLA","36","30","66"
"12944","REVERENDO PADRE PATRICIO CARIOLA","2101","ANTOFAGASTA","52","59","111"
"12945","ESCUELA ECOLOGICA PADRE ALBERTO HURTADO","2101","ANTOFAGASTA","29","37","66"
"12962","ESCUELA ELMO FUNEZ CARRIZO","2101","ANTOFAGASTA","52","44","96"
"12972","COLEGIO LA CONCEPCION","2101","ANTOFAGASTA","0","1","1"
"12980","LICEO BICENTENARIO DIEGO PORTALES PALAZUELOS","2201","CALAMA","35","43","78"
"13104","ESCUELA MANUEL ORELLA ECHANEZ","3102","CALDERA","25","39","64"
"13118","ESC. BASICA MARTA EMILIANA AGUILAR ZERON","3103","TIERRA AMARILLA","23","22","45"
"13121","ESC.BASICA CAPITAN RAFAEL TORREBLANCA","3301","VALLENAR","12","15","27"
"13122","CENTRO EDUC.INTEGRADA ADULTOS  C.E.I.A","3301","VALLENAR","5","6","11"
"13133","ESCUELA MANUEL RODRIGUEZ","3101","COPIAPO","13","15","28"
"13134","ESCUELA MIREYA ZULETA ASTUDILLO","3304","HUASCO","21","20","41"
"13135","ESCUELA BASICA IGNACIO DOMEYKO","3201","CHAÑARAL","28","31","59"
"13143","BYRON GIGOUX JAMES","3102","CALDERA","16","18","34"
"13154","ESCUELA EL CHANAR","3101","COPIAPO","30","41","71"
"13163","ESCUELA EL PALOMAR","3101","COPIAPO","29","46","75"
"13167","ESCUELA EDMUNDO QUEZADA ARAYA","3301","VALLENAR","24","25","49"
"13170","ESCUELA BASICA SARA CORTES CORTES","3202","DIEGO DE ALMAGRO","32","26","58"
"13176","CENTRO DE EDUCACION INTEGRADA DE ADULTOS","3101","COPIAPO","15","18","33"
"13177","ESCUELA VILLA LAS PLAYAS","3102","CALDERA","16","32","48"
"13181","ESCUELA EMILIA SCHWABE RUMOHR","3303","FREIRINA","15","18","33"
"13185","LICEO POLITECNICO","3301","VALLENAR","1","2","3"
"13186","CENTRO DE EDUCACION INTEGRADA DE ADULTOS","3202","DIEGO DE ALMAGRO","1","5","6"
"13193","C.E.I.A. CALDERA","3102","CALDERA","2","5","7"
"13202","LICEO BICENTENARIO DE VALLENAR","3301","VALLENAR","49","35","84"
"13358","ESCUELA JUAN RENDIC","4106","VICUÑA","9","7","16"
"13387","COLEGIO DE ARTES ELISEO VIDELA JORQUERA","4301","OVALLE","26","34","60"
"13423","ESCUELA BASICA AMANECER","4305","RIO HURTADO","6","6","12"
"13428","ESCUELA BASICA SAN ISIDRO DE CUZ CUZ","4201","ILLAPEL","7","10","17"
"13462","COLEGIO CERRO GUAYAQUIL","4303","MONTE PATRIA","17","15","32"
"13463","COLEGIO CARLOS CONDELL DE LA HAZA","4101","LA SERENA","23","50","73"
"13494","ESCUELA BASICA LA VILLA","4303","MONTE PATRIA","8","10","18"
"13512","COLEGIO JOAQUIN VICUÐA LARRAIN","4106","VICUÑA","11","18","29"
"13557","ESCUELA BASICA REPUBLICA DE ITALIA","4102","COQUIMBO","13","13","26"
"13558","INSTITUTO DE ADM. Y COMERCIO ESTADO DE ISRAEL","4102","COQUIMBO","24","14","38"
"13559","ESCUELA REPUBLICA DE GRECIA","4102","COQUIMBO","14","20","34"
"13560","ESCUELA PADRE ALBERTO HURTADO CRUCHAGA","4102","COQUIMBO","17","10","27"
"13561","LIC.DE CIENC.Y HUM.SAN JOSEMARIA ESCRIVA","4102","COQUIMBO","28","10","38"
"13562","ESCUELA JUAN PABLO II","4102","COQUIMBO","11","11","22"
"13563","COLEGIO NUESTRA SEÑORA DEL ROSARIO","4103","ANDACOLLO","14","13","27"
"13570","ESCUELA MUNICIPAL VILLA SANTA ROSA","4204","SALAMANCA","0","5","5"
"13576","LICEO TECNICO FEMENINO LAS COMPANIAS","4101","LA SERENA","6","0","6"
"13590","COLEGIO DE ADMINISTRACION Y COMERCIO EL INGENIO","4301","OVALLE","15","17","32"
"13591","CENTRO INTEGRAL DE ADULTOS LIMARI","4301","OVALLE","10","10","20"
"14202","COLEGIO PANQUEHUE","5704","PANQUEHUE","10","16","26"
"14208","CENTRO INTEGRAL DE EDUCACION DE ADULTOS","5501","QUILLOTA","19","17","36"
"14454","LIC.EDUC.DE ADULTOS JUAN F.GONZALEZ R.","5701","SAN FELIPE","1","3","4"
"14479","ESCUELA BASICA MUNICIPAL ARAUCARIA","5402","CABILDO","32","36","68"
"14678","ESCUELA JUAN DE SAAVEDRA","5101","VALPARAISO","5","7","12"
"14697","LICEO BICENTENARIO CORDILLERA DE SAN FELIPE","5701","SAN FELIPE","38","29","67"
"14720","LICEO GASTRONOMIA Y TURISMO","5801","QUILPUE","11","17","28"
"14881","LICEO ALDEA EDUCATIVA RAPA NUI","5201","ISLA DE PASCUA","24","32","56"
"15526","ESCUELA MUNICIPAL AMERICA","6204","MARCHIHUE","24","21","45"
"15535","ESCUELA SANTA TERESA DE AVILA","6115","RENGO","15","11","26"
"15570","ESCUELA BASICA GALVARINO VALENZUELA MORAGA","6304","LOLOL","14","16","30"
"15574","LICEO MUNICIPAL DE ADULTOS SANTA CRUZ","6310","SANTA CRUZ","15","10","25"
"15596","INSTITUTO SAN VICENTE DE TAGUA TAGUA","6117","SAN VICENTE","14","29","43"
"15608","ESCUELA SAN HERNAN","6301","SAN FERNANDO","18","16","34"
"15614","ESCUELA EL NARANJAL","6115","RENGO","30","43","73"
"15724","ESCUELA FERNANDA AEDO FAUNDEZ","6115","RENGO","32","23","55"
"15728","COLEGIO MUNICIPAL HUALLILEN","6103","COINCO","13","9","22"
"15753","COLEGIO BENJAMIN VICUÑA MACKENNA","6101","RANCAGUA","9","15","24"
"15759","LICEO MACHALI","6108","MACHALI","6","10","16"
"15762","COLEGIO MARÍA ESCOBILLANA GUZMÁN","6106","GRANEROS","16","16","32"
"15768","COLEGIO SANTA FILOMENA","6101","RANCAGUA","15","22","37"
"15770","ESCUELA DIVINO MAESTRO","6201","PICHILEMU","19","23","42"
"15781","LICEO MUNICIPAL DE CODEGUA","6102","CODEGUA","6","8","14"
"16424","LICEO BICENTENARIO DE MOLINA MARIA DEL TRÁNSITO DE LA CRUZ","7304","MOLINA","5","16","21"
"16428","ESC. MONSENOR MANUEL LARRAIN ERRAZURIZ","7302","HUALAÑE","27","43","70"
"16460","ESCUELA PADRE ALBERTO HURTADO","7301","CURICO","27","36","63"
"16468","ESCUELA BASICA DE COLBUN","7402","COLBUN","29","47","76"
"16469","COLEGIO PABLO NERUDA","7404","PARRAL","51","33","84"
"16506","ESCUELA CHACARILLAS","7102","CONSTITUCION","10","19","29"
"16580","ESC. PASO INTERNACIONAL PEHUENCHE","7109","SAN CLEMENTE","38","28","66"
"16676","LICEO COMPLEJO EDUCACIONAL JAVIERA CARRERA","7101","TALCA","41","47","88"
"16715","COLEGIO EL BOLDO","7301","CURICO","29","33","62"
"16716","LICEO ZAPALLAR","7301","CURICO","37","35","72"
"16729","INSTITUTO INGLES","7301","CURICO","8","5","13"
"16748","LICEO BICENTENARIO ORIENTE DE TALCA","7101","TALCA","18","30","48"
"16751","LICEO BICENTENARIO DE CAUQUENES","7201","CAUQUENES","16","18","34"
"16754","LICEO ARTURO ALESSANDRI PALMA","7306","ROMERAL","0","1","1"
"16879","ESCUELA BÁSICA N°2442 `CENTRO EDUCACIONAL ERNESTO YAÑEZ RIVERA`","13107","HUECHURABA","18","22","40"
"16958","COLEGIO  ARTISTICO SOL DEL  ILLIMANI","13110","LA FLORIDA","18","18","36"
"16985","LICEO DE ALTA EXIGENCIA PAULO FREIRE","10208","QUELLON","9","14","23"
"17654","CENTRO EDUCACIÓN INTEGRADA DE ADULTOS","8102","CORONEL","12","13","25"
"17693","COLEGIO BASICO NUEVA LOS LOBOS","8110","TALCAHUANO","25","28","53"
"17698","ESCUELA RAMÓN VINAY SEPÚLVEDA","8401","CHILLAN","39","35","74"
"17709","ESCUELA BALMACEDA SAAVEDRA L.","8103","CHIGUAYANTE","14","10","24"
"17723","ESCUELA DIEGO PORTALES","8109","SANTA JUANA","11","10","21"
"17741","ESCUELA REINO DE SUECIA","8403","COBQUECURA","15","10","25"
"17742","ESCUELA BASICA EDUARDO FREI MONTALBA","8402","BULNES","9","13","22"
"17751","ESCUELA VILLA LA GRANJA","8305","MULCHEN","33","28","61"
"17782","LICEO RIOS DE CHILE","8107","PENCO","12","17","29"
"17785","ESCUELA VILLA CENTINELA SUR","8110","TALCAHUANO","13","12","25"
"17787","ESCUELA ORLANDO VERA VILLARROEL","8303","CABRERO","31","32","63"
"17813","ESCUELA BÁSICA CACIQUE LEVIÁN","8311","SANTA BARBARA","17","22","39"
"17814","ESCUELA ALTO CABRERO","8303","CABRERO","33","42","75"
"17847","INSTITUTO EDUCACIÓN DE ADULTOS RUBÉN CAMPOS LÓPEZ","8304","LAJA","6","6","12"
"17874","ESCUELA EDELMIRA VERGARA QUIÑONES","8202","ARAUCO","21","23","44"
"17880","CENTRO DE EDUCACIÓN DE ADULTOS ADELAILA MORENO","8312","TUCAPEL","0","2","2"
"17881","CENTRO EDUCACIÓN INTEGRADO ADULTOS FERMÍN FIERRO LUENGO","8205","CURANILAHUE","18","12","30"
"17892","ESCUELA MARTA COLVIN ANDRADE","8401","CHILLAN","15","21","36"
"17897","ESCUELA GLORIAS NAVALES","8408","NINHUE","10","13","23"
"17898","ESCUELA SERGIO MARTIN ALAMOS","8419","SAN NICOLAS","12","12","24"
"17916","ESCUELA DAFNE ELVIRA ZAPATA ROZAS","8410","PEMUCO","15","33","48"
"17924","ESCUELA NACIMIENTO DE NUESTRO SEÑOR","8306","NACIMIENTO","9","18","27"
"17930","ESCUELA EL LLANO","8414","QUIRIHUE","8","9","17"
"18002","ESCUELA JOSE FRANCISCO PINO MEDINA","8404","COELEMU","30","28","58"
"18006","ESCUELA ELISE MOTTART","8407","EL CARMEN","26","19","45"
"18009","CENTRO INTEGRAL ADULTOS PAUL PERCIVAL HARRIS","8202","ARAUCO","4","1","5"
"18012","ESCUELA MARTA COLVIN ANDRADE","8405","COIHUECO","17","24","41"
"18014","ESCUELA BASICA LOS CONQUISTADORES","8107","PENCO","15","17","32"
"18015","ESCUELA BASICA FORJADORES DE CHILE","8107","PENCO","13","10","23"
"18017","LICEO TÉCNICO PROFESIONAL VIOLETA PARRA SANDOVAL","8416","SAN CARLOS","17","20","37"
"18021","ESCUELA DIEGO PORTALES PALAZUELOS","8313","YUMBEL","1","11","12"
"18065","ESCUELA NUEVA REPUBLICA","8105","HUALQUI","20","33","53"
"18099","ESCUELA TOMAS LAGO","8406","CHILLAN VIEJO","13","23","36"
"18112","LICEO INES ENRIQUEZ FRODDEN","8104","FLORIDA","11","21","32"
"18218","COLEGIO NUEVOS HORIZONTES","8108","SAN PEDRO DE LA PAZ","22","25","47"
"19906","LICEO POLITECNICO EMA ESPINOZA CORREA","9108","LAUTARO","9","7","16"
"19927","ESCUELA BASICA VOLCAN LLAIMA","9110","MELIPEUCO","17","10","27"
"19993","C.E.I.A. ANTONIO ACEVEDO HERNANDEZ","9201","ANGOL","9","2","11"
"20025","ESCUELA ARTISTICA ARMANDO DUFEY BLANC","9101","TEMUCO","37","28","65"
"20121","ESCUELA MUNICIPAL LOS ARRAYANES","9115","PUCON","14","21","35"
"20200","ESCUELA MUNICIPAL GABRIELA MISTRAL","9106","GALVARINO","10","22","32"
"20248","LICEO MUNICIPAL TROVOLHUE","9102","CARAHUE","4","10","14"
"20266","LICEO BICENTENARIO DE TEMUCO","9101","TEMUCO","43","26","69"
"20376","ESCUELA NUEVA ALERCE","10101","PUERTO MONTT","37","39","76"
"20393","CENTRO DE EDUCACION INTEGRADA DE ADULTOS POETA ALFONSO MORA","8111","TOME","18","4","22"
"20409","ESCUELA HOSPITALARIA PUERTO MONTT","10101","PUERTO MONTT","1","1","2"
"20427","ESCUELA BASICA ÑIPAS","8415","RANQUIL","17","9","26"
"20440","ESCUELA BÁSICA DOCTOR JUAN VERDAGUER PLANAS","13127","RECOLETA","17","18","35"
"22083","ESCUELA BASICA ALMIRANTE JUAN JOSE LATORRE","10401","CHAITEN","7","13","20"
"22086","LICEO RURAL LAS QUEMAS","10101","PUERTO MONTT","8","12","20"
"22098","ESCUELA RURAL INIO","10208","QUELLON","0","2","2"
"22105","ESCUELA BASICA FRESIA","10104","FRESIA","38","35","73"
"22112","ESCUELA RURAL PUNTA WHITE","10208","QUELLON","2","3","5"
"22130","ESCUELA  ALLA-KINTUY","10208","QUELLON","13","16","29"
"22175","ESCUELA PABLO NERUDA","10101","PUERTO MONTT","25","27","52"
"22229","ESCUELA BASICA LICARAYEN","10101","PUERTO MONTT","9","15","24"
"22307","CENTRO DE EDUCACION DE ADULTOS QUELLON","10208","QUELLON","16","20","36"
"22309","COLEGIO INGLÉS MABEL CONDEMARÍN","10106","LOS MUERMOS","27","18","45"
"22333","ESCUELA FRANCIA","14101","VALDIVIA","19","33","52"
"22354","ESCUELA EL MAITEN","14201","LA UNION","12","11","23"
"22380","ESCUELA BASICA SECTOR ORIENTE","10208","QUELLON","24","28","52"
"22403","ESCUELA DE CULTURA Y DIFUSION ARTISTICA FRIDOLINA BARRIENTOS CANOBRA","10201","CASTRO","15","7","22"
"22414","ESCUELA PAMPA RIOS","14204","RIO BUENO","33","36","69"
"22418","ESCUELA BASICA KIMUN LAWAL","10101","PUERTO MONTT","51","51","102"
"22419","ESCUELA PADRE ALBERTO HURTADO","10101","PUERTO MONTT","26","40","66"
"22420","ESCUELA NUEVA PENSYLVANIA","10108","MAULLIN","7","12","19"
"22430","COLEGIO CRECER","10303","PURRANQUE","7","11","18"
"22476","COLEGIO SAN JOSE","14106","MARIQUINA","8","11","19"
"22480","COLEGIO LOS ALERCES","10101","PUERTO MONTT","30","38","68"
"22483","LICEO BICENTENARIO DE EXCELENCIA ALTAMIRA","14108","PANGUIPULLI","37","26","63"
"22493","ESCUELA VICENTE PEREZ ROSALES","10105","FRUTILLAR","16","15","31"
"22504","LICEO FRANCISCO COLOANE","10201","CASTRO","12","21","33"
"22509","ESCUELA ALEMANIA","10101","PUERTO MONTT","17","19","36"
"22519","COLEGIO MIRADOR DEL LAGO","10109","PUERTO VARAS","42","40","82"
"22531","ESCUELA CLAUDIO ARRAU LEON","14108","PANGUIPULLI","16","13","29"
"22532","ESCUELA EL BOSQUE","14101","VALDIVIA","18","30","48"
"22535","ESCUELA TERESA DE LOS ANDES","10201","CASTRO","37","44","81"
"22539","ESCUELA JOSE MANUEL BALMACEDA","10102","CALBUCO","11","13","24"
"22540","INSTITUTO ITALIA DE VALDIVIA","14101","VALDIVIA","9","10","19"
"22544","LICEO CIENTIFICO HUMANISTA BENJAMIN VICUÑA MACKENNA","10101","PUERTO MONTT","3","8","11"
"22549","CENTRO DE EDUCACIÓN INTEGRAL DE ADULTOS NUEVO HORIZONTE","14108","PANGUIPULLI","3","1","4"
"22553","INSTITUTO TÉCNICO FORJADORES DE ALERCE","10101","PUERTO MONTT","3","3","6"
"22554","ESCUELA BASICA SAN CARLOS DE CHONCHI","10203","CHONCHI","37","32","69"
"22558","ESCUELA NUEVA COLLILELFU","14104","LOS LAGOS","19","18","37"
"22686","ESCUELA BASICA LAS CAMELIAS","10101","PUERTO MONTT","31","29","60"
"22758","COMPLEJO EDUCACIONAL IGNAO","14203","LAGO RANCO","14","15","29"
"24203","LICEO RAUL BROUSSAIN CAMPINO","11201","AISEN","28","26","54"
"24215","CENTRO DE EDUCACION INTEGRADA DE ADULTOS","11101","COIHAIQUE","4","2","6"
"24240","LICEO BICENTENARIO ALTOS DEL MACKAY","11101","COIHAIQUE","37","23","60"
"24302","ESCUELA GENERAL MANUEL BULNES P.","12101","PUNTA ARENAS","28","30","58"
"24307","LICEO JUAN BAUTISTA CONTARDI","12101","PUNTA ARENAS","61","48","109"
"24313","ESCUELA VILLA LAS NIEVES","12101","PUNTA ARENAS","37","30","67"
"24318","ESCUELA PADRE ALBERTO HURTADO CRUCHAGA","12101","PUNTA ARENAS","22","40","62"
"24325","ESCUELA RURAL CERRO GUIDO","12402","TORRES DEL PAINE","1","0","1"
"24332","CEIA CARLOS YANEZ MOYA","12401","NATALES","2","2","4"
"24401","COLEGIO CAPITAN PASTENE","13110","LA FLORIDA","14","21","35"
"24403","COLEGIO SIMON BOLIVAR","13112","LA PINTANA","15","13","28"
"24412","COLEGIO FINLANDIA","13124","PUDAHUEL","25","31","56"
"24443","LICEO MUNICIPAL CHILOE","13201","PUENTE ALTO","40","39","79"
"24445","LICEO MUNICIPAL EL ROBLE","13112","LA PINTANA","18","19","37"
"24464","ESCUELA BASICA MERCEDES MARIN DEL SOLAR","13123","PROVIDENCIA","31","43","74"
"24520","ESC. BAS.MUNICIPAL MERCEDES FONTECILLA","13125","QUILICURA","51","44","95"
"24622","MIGUEL DE CERVANTES Y SAAVEDRA ANEXO A-8","13101","SANTIAGO","41","72","113"
"24654","ESCUELA BASICA CINCO PINOS","13401","SAN BERNARDO","7","9","16"
"24716","ESCUELA BASICA LOS NAVIOS","13110","LA FLORIDA","27","35","62"
"24721","COLEGIO LEONARDO DA VINCI DE LAS CONDES","13114","LAS CONDES","27","10","37"
"24751","COMPLEJO EDUC. EDUARDO CUEVAS VALDES","13115","LO BARNECHEA","16","13","29"
"24754","CEIA GEORGINA SALAS DINAMARCA","13103","CERRO NAVIA","22","12","34"
"24822","ESC. BAS. PDTE. SALVADOR ALLENDE G.","13105","EL BOSQUE","18","18","36"
"24856","ESCUELA BASICA TEGUALDA","13601","TALAGANTE","24","32","56"
"24876","ESC.BASICA PROF.AURELIA ROJAS BURGOS","13112","LA PINTANA","44","35","79"
"24883","ESCUELA BÁSICA MUNICIPAL SAN LUIS","13119","MAIPU","30","26","56"
"24889","LICEO MONSENOR ENRIQUE ALVEAR","13124","PUDAHUEL","46","45","91"
"24959","COMPL.EDUCACIONAL BRIGIDA WALKER  ANEXO","13120","ÑUÑOA","11","9","20"
"24987","ESCUELA ANDES DEL SUR","13201","PUENTE ALTO","26","38","64"
"24997","ESCUELA SANTA MARIA DE PENALOLEN","13122","PEÑALOLEN","17","20","37"
"24999","ESCUELA PROFESORA MARIA LUISA SEPULVEDA","13125","QUILICURA","24","23","47"
"25002","ESCUELA BASICA PADRE ALBERTO HURTADO","13201","PUENTE ALTO","35","28","63"
"25009","LICEO VALLE DE LLUTA","13401","SAN BERNARDO","45","28","73"
"25041","COLEGIO MARIA ELENA","13110","LA FLORIDA","28","33","61"
"25042","ESCUELA BASICA LOS BOSQUINOS","13119","MAIPU","53","47","100"
"25043","ESCUELA VOLCAN SAN JOSE","13201","PUENTE ALTO","22","16","38"
"25047","ESCUELA ANTILHUE DE PUDAHUEL","13124","PUDAHUEL","45","44","89"
"25078","ESCUELA PART.COMANDANTE CARLOS CONDELL","13401","SAN BERNARDO","24","37","61"
"25089","COLEGIO LOS JAZMINES","13501","MELIPILLA","41","61","102"
"25173","ESC. BASICA MUNICIPAL RISOPATRON","13121","PEDRO AGUIRRE CERDA","10","17","27"
"25186","COLEGIO MUNIC.  SAN SEBASTIAN DE RINCONADA","13119","MAIPU","43","54","97"
"25189","ESCUELA BASICA FUTURO LAS MERCEDES","13603","ISLA DE MAIPO","3","6","9"
"25194","ESCUELA MUNICIPAL VALLE DE LUNA","13125","QUILICURA","22","28","50"
"25235","LICEO DE ADULTOS POETA VICENTE HUIDOBRO","13125","QUILICURA","39","38","77"
"25314","ESCUELA BÁSICA 1737 LOS ALERCES DE MAIPÚ","13119","MAIPU","44","50","94"
"25315","ESCUELA PUERTO FUTURO","13124","PUDAHUEL","25","34","59"
"25339","LICEO MUNICIPAL DE ADULTO MIGUEL CAMPINO LARRAIN","13404","PAINE","3","8","11"
"25435","ESCUELA BASICA DEL PONIENTE","13601","TALAGANTE","67","58","125"
"25514","INSTITUTO DE EDUCACION DE ADULTOS MACUL","13118","MACUL","11","14","25"
"25539","EJERCITO LIBERTADOR DE CERRILLOS","13102","CERRILLOS","11","13","24"
"25591","LICEO TECNICO PROFESIONAL DE BUIN","13402","BUIN","13","7","20"
"25592","CENTRO EDUCATIVO LA PUERTA","13301","COLINA","1","7","8"
"25630","LICEO POLIV. SAN JOSE DE LO BARNECHEA","13115","LO BARNECHEA","13","14","27"
"25642","ESCUELA BAS. MUNIC. CUYUNCAVI","13503","CURACAVI","9","5","14"
"25698","COLEGIO JAIME GUZMÁN ERRAZURIZ","13401","SAN BERNARDO","21","26","47"
"25711","ESC. BASICA MUNICIPAL PAULA JARAQUEMADA ALQUI","13404","PAINE","32","30","62"
"25770","LICEO NACIONAL DE MAIPU","13119","MAIPU","0","185","185"
"25788","ESCUELA BASICA ANA FRANK","13125","QUILICURA","39","39","78"
"25797","ESCUELA B-SICA PUCARA LASANA","13125","QUILICURA","8","13","21"
"25823","ESCUELA DE LAS ARTES Y LA TECNOLOGIA","13119","MAIPU","9","6","15"
"25855","COLEGIO MUNICIPAL INSTITUTO CHACABUCO","13301","COLINA","60","48","108"
"25960","CENTRO EDUC. PADRE ALBERTO HURTADO DE SAN BER","13401","SAN BERNARDO","31","48","79"
"26037","INSTITUTO ESTADOS AMERICANOS LO BARNECHEA","13115","LO BARNECHEA","27","25","52"
"26157","LICEO MUNICIPAL DE BATUCO","13302","LAMPA","12","17","29"
"26333","C. INTEGRAL DE AD. PROFESORA TERESA MOYA REYE","13201","PUENTE ALTO","9","21","30"
"31010","LICEO BICENTENARIO CIUDAD DE LOS RIOS VALDIVI","14101","VALDIVIA","44","20","64"
"31037","LICEO INSTITUTO CUMBRE DE CONDORES","13128","RENCA","56","24","80"
"31065","LICEO TECNOLOGICO ENRIQUE KIRBERG B","13119","MAIPU","77","35","112"
"31071","LICEO BICENT. PROV.STA. TERESA DE LOS ANDES","13301","COLINA","68","56","124"
"31074","LICEO BICENTENARIO DE NIÑAS DE MAIPU","13119","MAIPU","165","0","165"
"31078","LICEO BICENTENARIO SAN PEDRO DE PUENTE ALTO","13201","PUENTE ALTO","57","26","83"
"31103","LICEO BICENTENARIO DE CORONEL","8102","CORONEL","51","28","79"
"31153","INSTITUTO CUMBRES DE CONDORES PONIENTE","13128","RENCA","25","16","41"
"31288","LICEO BICENTENARIO DE  EXCELENCIA NACIONAL DE","13103","CERRO NAVIA","10","5","15"
"31293","LICEO NACIONAL BICENTENARIO DE EXCELENCIA","13401","SAN BERNARDO","37","37","74"
"31299","LICEO BICENTENARIO DE EXCELENCIA FRANCISCO BILBAO BARQUIN DE QUILICURA","13125","QUILICURA","38","42","80"
"31343","LICEO CIENTIFICO HUMANISTA LA CHIMBA","2101","ANTOFAGASTA","18","38","56"
"31345","LICEO POLITÉCNICO LOS ARENALES","2101","ANTOFAGASTA","9","8","17"
"31432","LICEO ALTO CORDILLERA DE LA FLORIDA","13110","LA FLORIDA","13","21","34"
"40025","LICEO REQUINOA","6116","REQUINOA","17","16","33"
"40078","ESCUELA CARDENAL RAUL SILVA HENRIQUEZ","6203","LITUECHE","25","23","48"
"40114","LICEO ORIENTE","6115","RENGO","83","48","131"
"40242","COLEGIO BICENTENARIO","5402","CABILDO","12","18","30"
"40289","INSTITUTO BICENTENARIO J.MIGUEL CARRERA","5601","SAN ANTONIO","22","13","35"
"40352","LICEO TEC.PROFESIONAL PEDRO AGUIRRE CERDA","5302","CALLE LARGA","2","6","8"
"40383","ESCUELA BASICA MIL PAISAJES-QUEMCHI","10209","QUEMCHI","11","21","32"
